DPProjektTeaJelavic
An Interactive Fiction by Tea Jelavic
Release 1 / Serial number 230109 / Inform 7 build 6M62 (I6/v6.33 lib 6/12N) SD

Prvi kat
Dobrodošli u Shopping kraljicu i City Centar. Vaš shopping može započeti! Nalazite se na prvom katu. Na prvom se katu nalaze drogerije. Istočno je Dm, a zapadno Bipa. Ako želite ići na drugi kat, popnite se skalama sjeverno, a za izlaz iz centra idite na jug. Za početak pročitajte Vaš zadatak na Shopping kraljica info pultu.

You can see Shopping kraljica info pult here.

I beg your pardon?

>e
Zara
Ušli ste u dućan Zara.

>n
You can't go that way.

>w
Hodnik 1
Dobrodošli u City Centar. Vaš shopping može započeti! :)

>w
Nike
Ušli ste u dućan Nike.

>e
Hodnik 1
Dobrodošli u City Centar. Vaš shopping može započeti! :)

* * *

DPProjektTeaJelavic
An Interactive Fiction by Tea Jelavic
Release 1 / Serial number 230109 / Inform 7 build 6M62 (I6/v6.33 lib 6/12N) SD

Prvi kat
Dobrodošli u Shopping kraljicu i City Centar. Vaš shopping može započeti! Nalazite se na prvom katu. Na prvom se katu nalaze drogerije. Istočno je Dm, a zapadno Bipa. Ako želite ići na drugi kat, popnite se skalama sjeverno, a za izlaz iz centra idite na jug. Za početak pročitajte Vaš zadatak na Shopping kraljica info pultu.

You can see Shopping kraljica info pult here.

>n
Skale12
Vozite se pokretnim skalama. Idite gore ako se želite popeti ili dole ako se želite spustiti.

>n
Drugi kat
Popeli ste se na drugi kat. Na drugom se katu nalaze trgovine s odjećom. Istočno je Zara, a zapadno Mango. Ako želite ići na treći kat, popnite se skalama sjeverno, a ako želite ići na prvi kat idite na jug.

>s
Skale12
Vozite se pokretnim skalama. Idite gore ako se želite popeti ili dole ako se želite spustiti.

>n
Drugi kat
Popeli ste se na drugi kat.

* * *

>s
Skale12
Vozite se pokretnim skalama. Idite gore ako se želite popeti ili dole ako se želite spustiti.

>s
Prvi kat
Dobrodošli u Shopping kraljicu i City Centar. Vaš shopping može započeti! Nalazite se na prvom katu. Na prvom se katu nalaze drogerije. Istočno je Dm, a zapadno Bipa. Ako želite ići na drugi kat, popnite se skalama sjeverno, a za izlaz iz centra idite na jug. Za početak pročitajte Vaš zadatak na Shopping kraljica info pultu.

>n
Skale12
Vozite se pokretnim skalama. Idite gore ako se želite popeti ili dole ako se želite spustiti.

>s
Prvi kat
Dobrodošli u City Centar. Vaš shopping može započeti! Nalazite se na prvom katu. :)

* * *

>n
Drugi kat
Popeli ste se na drugi kat. Na drugom se katu nalaze trgovine s odjećom. Istočno je Zara, a zapadno Mango. Ako želite ići na treći kat, popnite se skalama sjeverno, a ako želite ići na prvi kat idite na jug.

>n
Skale23
Vozite se pokretnim skalama. Idite gore ako se želite popeti ili dole ako se želite spustiti.

>n
Treci kat
Popeli ste se na treći kat. Na trecem se katu nalaze trgovine s obućom. Istočno je Shooster, sjeverno Mass, a zapadno Buzz. Ako želite ići na drug kat idite na jug.

Na sredini se nalazi kutija iznenađenja.

>look kutija
Otvori kutiju jer te unutra čeka neko iznenađenje!

>open kutija
You open Kutija iznena enja, revealing Poklon bon od 10 eura.

>take poklon bon
Taken.

>look fond
You can't see any such thing.

>s
Skale23
Vozite se pokretnim skalama. Idite gore ako se želite popeti ili dole ako se želite spustiti.

>s
Drugi kat
Popeli ste se na drugi kat. Na drugom se katu nalaze trgovine s odjećom. Istočno je Zara, a zapadno Mango. Ako želite ići na treći kat, popnite se skalama sjeverno, a ako želite ići na prvi kat idite na jug.

>s
Skale12
Vozite se pokretnim skalama. Idite gore ako se želite popeti ili dole ako se želite spustiti.

* * *

>s
Prvi kat
Dobrodošli u Shopping kraljicu i City Centar. Vaš shopping može započeti! Nalazite se na prvom katu. Na prvom se katu nalaze drogerije. Istočno je Dm, a zapadno Bipa. Ako želite ići na drugi kat, popnite se skalama sjeverno, a za izlaz iz centra idite na jug. Za početak pročitajte Vaš zadatak na Shopping kraljica info pultu.

>open koverta
You open Koverta, revealing Fond.

>take fond
Taken.

>look fond
250 €.

* * *

>n
Drugi kat
Popeli ste se na drugi kat. Na drugom se katu nalaze trgovine s odjećom. Istočno je Zara, a zapadno Mango. Ako želite ići na treći kat, popnite se skalama sjeverno, a ako želite ići na prvi kat idite na jug.

>e
Zara
Ušli ste u dućan Zara.

On Zara kasa is Zara kupon s popustom od 7 eura.

You can also see Hlace and Haljina here.

>look polica
Na polici se nalaze crne hlace i crvena haljina.

>w
Drugi kat
Popeli ste se na drugi kat. Na drugom se katu nalaze trgovine s odjećom. Istočno je Zara, a zapadno Mango. Ako želite ići na treći kat, popnite se skalama sjeverno, a ako želite ići na prvi kat idite na jug.

>w
Mango
Ušli ste u dućan Mango. Ispred vas se nalazi Mango polica.

>look polica
Na polici se nalaze bijela kosulja i roza minica.

>look kasa
Pozdrav. Sada ću vam naplatiti vaše artikle.

>look Mango kasa
Pozdrav. Sada ću vam naplatiti vaše artikle.

>look Mango polica
Na polici se nalaze bijela kosulja i roza minica.

* * *

>look polica
Na polici se nalaze crne hlace i crvena haljina.

>take crvena haljina
Moraš prvo platiti crvenu haljinu na kasi!

>look kasa
Pozdrav. Sada ću vam naplatiti vaše artikle.

>w
Drugi kat
Popeli ste se na drugi kat. Na drugom se katu nalaze trgovine s odjećom. Istočno je Zara, a zapadno Mango. Ako želite ići na treći kat, popnite se skalama sjeverno, a ako želite ići na prvi kat idite na jug.

>n
Skale23
Vozite se pokretnim skalama. Idite gore ako se želite popeti ili dole ako se želite spustiti.

>n
Treci kat
Popeli ste se na treci kat. Na trecem se katu nalaze trgovine s obućom. Istočno je Shooster, sjeverno Mass, a zapadno Buzz. Ako želite ići na drug kat idite na jug.

>w
You can't go that way.

* * *

>e
Zara
Ušli ste u dućan Zara.

On Zara kasa is Zara kupon s popustom od 7 eura.

You can also see Hlace and Haljina here.

>w
Drugi kat
Popeli ste se na drugi kat. Na drugom se katu nalaze trgovine s odjećom. Istočno je Zara, a zapadno Mango. Ako želite ići na treći kat, popnite se skalama sjeverno, a ako želite ići na prvi kat idite na jug.

>s
Skale12
Vozite se pokretnim skalama. Idite gore ako se želite popeti ili dole ako se želite spustiti.

>s
Prvi kat
Dobrodošli u Shopping kraljicu i City Centar. Vaš shopping može započeti! Nalazite se na prvom katu. Na prvom se katu nalaze drogerije. Istočno je Dm, a zapadno Bipa. Ako želite ići na drugi kat, popnite se skalama sjeverno, a za izlaz iz centra idite na jug.

Za početak pročitajte Vaš zadatak na Shopping kraljica info kutiji.

>e
Dm
Ušli ste u dućan Dm.

You can see Sjajilo and Labelo here.

>w
Prvi kat
Dobrodošli u Shopping kraljicu i City Centar. Vaš shopping može započeti! Nalazite se na prvom katu. Na prvom se katu nalaze drogerije. Istočno je Dm, a zapadno Bipa. Ako želite ići na drugi kat, popnite se skalama sjeverno, a za izlaz iz centra idite na jug.

Za početak pročitajte Vaš zadatak na Shopping kraljica info kutiji.

>w
Bipa
Ušli ste u dućan Bipa.

On Bipa kasa is Bipa kupon s popustom od 5 eura.

You can also see Maskara and Sjenilo here.

>take maskara
Moraš prvo platiti maskaru na kasi!

* * *

>n
Treci kat
Popeli ste se na treći kat. Na trecem se katu nalaze trgovine s obućom. Istočno je Shooster, sjeverno Mass, a zapadno Buzz. Ako želite ići na drug kat idite na jug.

Na sredini se nalazi kutija iznenađenja.

>w
Buzz
Ušli ste u dućan Buzz.

On Buzz kasa is Kupon s popustom.

You can also see Puma natikace and Champion natikace here.

>e
You can't go that way.

* * *

>w
Buzz
Ušli ste u dućan Buzz.

On Buzz kasa is Kupon s popustom.

You can also see Puma natikace and Champion natikace here.

>look kasa
Pozdrav. Sada ću vam naplatiti vaše artikle.

On Buzz kasa is Kupon s popustom.

>take kupon
Taken.

>drop kupon
Dropped.

>look kasa
Pozdrav. Sada ću vam naplatiti vaše artikle.

>take kupon
Taken.

* * *

>n
Treci kat
Popeli ste se na treći kat. Na trecem se katu nalaze trgovine s obućom. Istočno je Shooster, sjeverno Mass, a zapadno Buzz. Ako želite ići na drug kat idite na jug.

Na sredini se nalazi kutija iznenađenja.

>n
Mass
Ušli ste u dućan Mass.

You can see Salonke and Spagerice here.

>s
Treci kat
Popeli ste se na treci kat. Na trecem se katu nalaze trgovine s obućom. Istočno je Shooster, sjeverno Mass, a zapadno Buzz. Ako želite ići na drug kat idite na jug.

>w
Buzz
Ušli ste u dućan Buzz.

You can see Puma natikace and Champion natikace here.

>look at kasa
Pozdrav. Sada ću vam naplatiti vaše artikle.

* * *

>w
Buzz
Ušli ste u dućan Buzz.

You can see Puma natikace and Champion natikace here.

>look kasa
Pozdrav. Sada ću vam naplatiti vaše artikle.

In Buzz kasa is Kupon s popustom.

>look kasa
Pozdrav. Sada ću vam naplatiti vaše artikle.

In Buzz kasa is Kupon.

* * *

>n
Treci kat
Popeli ste se na treći kat. Na trecem se katu nalaze trgovine s obućom. Istočno je Shooster, sjeverno Mass, a zapadno Buzz. Ako želite ići na drug kat idite na jug.

Na sredini se nalazi kutija iznenađenja.

>look nagradna kutija
Otvori kutiju jer te unutra čeka nagrada iznenađenja.

>open nagradna kutija
You open Nagradna kutija, revealing Poklon bon od 10.

* * *

>n
Treci kat
Popeli ste se na treći kat. Na trecem se katu nalaze trgovine s obućom. Istočno je Shooster, sjeverno Mass, a zapadno Buzz. Ako želite ići na drug kat idite na jug.

Na sredini se nalazi kutija iznenađenja.

>look kutija
Otvori kutiju jer te unutra čeka nagrada iznenađenja.

>open kutija
You open Nagradna kutija, revealing Poklon bon od 10.

>take poklon bon
Taken.

>close kutija
You close Nagradna kutija.

>open kutija
You open Nagradna kutija.

>drop poklon bon
Dropped.

>close kutija
You close Nagradna kutija.

* * *

>open kutija
You open Nagradna kutija.

>take bon
Taken.

>leave bon
I only understood you as far as wanting to leave.

>drop bon
Dropped.

* * *

>open kutija
You open Nagradna kutija, revealing Poklon bon od 10.

>s
Skale23
Vozite se pokretnim skalama. Idite gore ako se želite popeti ili dole ako se želite spustiti.

>n
Treci kat
Popeli ste se na treci kat. Na trecem se katu nalaze trgovine s obućom. Istočno je Shooster, sjeverno Mass, a zapadno Buzz. Ako želite ići na drug kat idite na jug.

Na sredini se nalazi nagradna kutija.

* * *

>n
Treci kat
Popeli ste se na treći kat. Na trecem se katu nalaze trgovine s obućom. Istočno je Shooster, sjeverno Mass, a zapadno Buzz. Ako želite ići na drug kat idite na jug.

Na sredini se nalazi kutija iznenađenja.

>open kutija
You open Kutija iznena enja, revealing Poklon bon od 10 eura.

>take bon
Taken.

>look fond
You can't see any such thing.

>look fond
You can't see any such thing.

* * *

>look fond
250 €.

>e
Dm
Ušli ste u dućan Dm.

You can see Sjajilo and Labelo here.

>w
Prvi kat
Nalazite se na prvom katu. Na prvom se katu nalaze drogerije. Istočno je Dm, a zapadno Bipa. Ako želite ići na drugi kat, popnite se skalama sjeverno, a za izlaz iz centra idite na jug.

>w
Bipa
Ušli ste u dućan Bipa.

You can see Maskara and Sjenilo here.

>put maskara on Bipa kas
I only understood you as far as wanting to put Maskara on Bipa kasa.

>put maskara on Bipa kasa
Račun za maskaru je 32 €. Molim Vas stavite fond na kasu.

* * *

I beg your pardon?

>inventory
You are carrying:
  Fond
  Poklon bon od 10 eura

* * *

I beg your pardon?

>e
Prvi kat
Nalazite se na prvom katu. Na prvom se katu nalaze drogerije. Istočno je Dm, a zapadno Bipa. Ako želite ići na drugi kat, popnite se skalama sjeverno, a za izlaz iz centra idite na jug.

>n
Skale12
Vozite se pokretnim skalama. Idite gore ako se želite popeti ili dole ako se želite spustiti.

>e
You can't go that way.

>n
Drugi kat
Popeli ste se na drugi kat. Na drugom se katu nalaze trgovine s odjećom. Istočno je Zara, a zapadno Mango. Ako želite ići na treći kat, popnite se skalama sjeverno, a ako želite ići na prvi kat idite na jug.

>e
Zara
Ušli ste u dućan Zara.

You can see Hlace and Haljina here.

>put hlace on zara kasa
Račun za hlace je 35 €. Molim Vas stavite fond na kasu.

* * *

>n
Treci kat
Popeli ste se na treći kat. Na trecem se katu nalaze trgovine s obućom. Istočno je Shooster, sjeverno Mass, a zapadno Buzz. Ako želite ići na drug kat idite na jug.

Na sredini se nalazi kutija iznenađenja.

>look fond
You can't see any such thing.

>open kutija
You open Kutija iznena enja, revealing Poklon bon od 10 eura.

* * *

>n
Skale12
Vozite se pokretnim skalama. Idite gore ako se želite popeti ili dole ako se želite spustiti.

>s
Prvi kat
Dobrodošli u City Centar. Vaš shopping može započeti! Nalazite se na prvom katu. Na prvom se katu nalaze drogerije. Istočno je Dm, a zapadno Bipa. Ako želite ići na drugi kat, popnite se skalama sjeverno, a za izlaz i centra idite na jug.

>e
Dm
Ušli ste u dućan Dm.

You can see Sjajilo and Labelo here.

>take labelo
Moraš prvo platiti labelo na kasi!

>look at kasa
Pozdrav. Sada ću vam naplatiti vaše artikle.

>put labelo on kasa
(first taking Labelo)
Moraš prvo platiti labelo na kasi!

>put labelo on kasa
(first taking Labelo)
Moraš prvo platiti labelo na kasi!

>look at kasa
Pozdrav. Sada ću vam naplatiti vaše artikle.

>inventory
You are carrying nothing.

>take labelo
Moraš prvo platiti labelo na kasi!

>inventory
You are carrying nothing.

* * *

>n
Skale12
Vozite se pokretnim skalama. Idite gore ako se želite popeti ili dole ako se želite spustiti.

I beg your pardon?

>n
Drugi kat
Popeli ste se na drugi kat. Na drugom se katu nalaze trgovine s odjećom. Istočno je Zara, a zapadno Mango. Ako želite ići na treći kat, popnite se skalama sjeverno, a ako želite ići na prvi kat idite na jug.

* * *

>open kutija
You open Kutija iznena enja, revealing Poklon bon od 10 eura.

>look bon
Poklon bon od 10 €. Uzmi me!

>take bon
Taken.

>look bon
Poklon bon od 10 €.

>look fond
You can't see any such thing.

* * *

>open koverta
You open Koverta, revealing Fond.

>look fond
10 €

>take fond
Taken.

>look fond
260 €.

* * *

DPProjektTeaJelavic
An Interactive Fiction by Tea Jelavic
Release 1 / Serial number 230109 / Inform 7 build 6M62 (I6/v6.33 lib 6/12N) SD

Prvi kat
Dobrodošli u Shopping kraljicu i City Centar. Vaš shopping može započeti! Nalazite se na prvom katu. Na prvom se katu nalaze drogerije. Istočno je Dm, a zapadno Bipa. Ako želite ići na drugi kat, popnite se skalama sjeverno, a za izlaz iz centra idite na jug. Za početak pročitajte Vaš zadatak na Shopping kraljica info pultu.

You can see Shopping kraljica info pult here.

>e
Dm
Ušli ste u dućan Dm.

You can see Sjajilo and Labelo here.

>s
You can't go that way.

>w
Prvi kat
Dobrodošli u City Centar. Vaš shopping može započeti! Nalazite se na prvom katu. :)

>w
Vani
Izašli ste iz City Centra. Jeste li zadovoljni vašom trgovinom?

>e
Prvi kat
Dobrodošli u City Centar. Vaš shopping može započeti! Nalazite se na prvom katu. :)

>s
Interspar
Ušli ste u dućan Interspar.

>n
Prvi kat
Dobrodošli u City Centar. Vaš shopping može započeti! Nalazite se na prvom katu. :)

>n
Skale12
Vozite se pokretnim skalama.

>n
Drugi kat
Popeli ste se na drugi kat.

>s
Skale12
Vozite se pokretnim skalama.

>s
Prvi kat
Dobrodošli u City Centar. Vaš shopping može započeti! Nalazite se na prvom katu. :)

* * *

>e
Dm
Ušli ste u dućan Dm.

You can see Sjajilo and Labelo here.

>look Ruž
You can't see any such thing.

>look at Ruž
You can't see any such thing.

* * *

>e
Dm
Ušli ste u dućan Dm.

You can see Sjajilo and Labelo here.

>look at ruž
You can't see any such thing.

>take ruž
You can't see any such thing.

>e
You can't go that way.

>s
You can't go that way.

* * *

>w
Prvi kat
Dobrodošli u City Centar. Vaš shopping može započeti! Nalazite se na prvom katu. :)

>e
Dm
Ušli ste u dućan Dm.

Na polici se nalazi ruž.

>take ruž
You can't see any such thing.

* * *

>e
Dm
Ušli ste u dućan Dm.

You can see Sjajilo and Labelo here.

>take ruž
You can't see any such thing.

>take Ruž
You can't see any such thing.

>take Sjajilo
Taken.

* * *

>e
Dm
Ušli ste u dućan Dm.

You can see Sjajilo and Labelo here.

>take sjajilo
Moraš prvo platiti sjajilo na kasi!

>take labelo
Moraš prvo platiti labelo na kasi!

* * *

>take sjajilo
Moraš prvo platiti sjajilo na kasi!

>inventory
You are carrying nothing.

* * *

>take sjajilo
Moraš prvo platiti sjajilo na kasi!

>look kasa
Pozdrav. Molim Vas stavite svoj artikl na kasu da vam ga mogu naplatiti.

>put sjajilo on kasa
Hvala Vam na kupnji i doviđenja, preostalo Vam je još 235 eura.

* * *

>take sjajilo
Moraš prvo platiti sjajilo na kasi!

>put sjajilo on kasa
Nemate dovoljno novaca za kupiti labelo!

* * *

>e
Dm
Ušli ste u dućan Dm.

You can see Sjajilo and Labelo here.

>look at polica
Na polici se nalaze sjajilo i labelo.

>take labelo
Moraš prvo platiti labelo na kasi!

* * *

>look at polica
Na polici se nalaze sjajilo i labelo.

>take sjajilo
Moraš prvo platiti sjajilo na kasi!

>look at kasa
Pozdrav. Sada ću vam naplatiti vaše artikle.

* * *

>e
Dm
Ušli ste u dućan Dm.

You can see Sjajilo and Labelo here.

>take polica
That's hardly portable.

>take labelo
Moraš prvo platiti labelo na kasi!

* * *

>e
Dm
Ušli ste u dućan Dm.

You can see Sjajilo and Labelo here.

>look at sjajilo
Loreal Nude princess 213 gloss, 15.15 €.

>take sjajilo
Moraš prvo platiti sjajilo na kasi!

* * *

>e
Dm
Ušli ste u dućan Dm.

You can see Sjajilo and Labelo here.

>take labelo
Taken.

>look at kasa
Pozdrav. Molim vas stavite svoj artikl na kasu da vam ga mogu naplatiti.

>put labelo on kasa
Račun je je 3.2 €. Molim vas dajte mi novac.

>look at kasa
Pozdrav. Molim vas stavite svoj artikl na kasu da vam ga mogu naplatiti.

* * *

>e
Dm
Ušli ste u dućan Dm.

You can see Sjajilo and Labelo here.

>w
Prvi kat
Dobrodošli u Shopping kraljicu i City Centar. Vaš shopping može započeti! Nalazite se na prvom katu. Na prvom se katu nalaze drogerije. Istočno je Dm, a zapadno Bipa. Ako želite ići na drugi kat, popnite se skalama sjeverno, a za izlaz i centra idite na jug.

Za početak pročitajte Vaš zadatak na Shopping kraljica info kutiji i nakon toga je otvorite da biste preuzeli Vaš fond u iznosu od 250 €.

>look at info kutija
You see nothing special about Shopping kraljica info kutija.

* * *

>e
Dm
Ušli ste u dućan Dm.

You can see Sjajilo and Labelo here.

>put sjajilo on kasa
Nemate dovoljno novaca za kupiti sjajilo!

>w
Prvi kat
Dobrodošli u Shopping kraljicu i City Centar. Vaš shopping može započeti! Nalazite se na prvom katu. Na prvom se katu nalaze drogerije. Istočno je Dm, a zapadno Bipa. Ako želite ići na drugi kat, popnite se skalama sjeverno, a za izlaz iz centra idite na jug.

Za početak pročitajte Vaš zadatak na Shopping kraljica info kutiji.

>open kutina
You can't see any such thing.

>open kutija
You open Shopping kraljica info kutija, revealing Fond.

>take fond
Taken.

>e
Dm
Ušli ste u dućan Dm.

You can see Sjajilo and Labelo here.

>put sjajilo on kasa
Hvala Vam na kupnji i doviđenja, preostalo Vam je još 235 eura.

* * *

DPProjektTeaJelavic
An Interactive Fiction by Tea Jelavic
Release 1 / Serial number 230109 / Inform 7 build 6M62 (I6/v6.33 lib 6/12N) SD

Prvi kat
Dobrodošli u Shopping kraljicu i City Centar. Vaš shopping može započeti! Nalazite se na prvom katu. Na prvom se katu nalaze drogerije. Istočno je Dm, a zapadno Bipa. Ako želite ići na drugi kat, popnite se skalama sjeverno, a za izlaz iz centra idite na jug. Za početak pročitajte Vaš zadatak na Shopping kraljica info pultu.

You can see Shopping kraljica info pult here.

>take the ruž
You can't see any such thing.

>take The ruž
You can't see any such thing.

>e
Dm
Ušli ste u dućan Dm.

Na polici se nalazi ruž.

Na polici se nalazi sjajilo.

Na polici se nalazi labelo.

>take The ruž
You can't see any such thing.

>take the ruž
You can't see any such thing.

>take Ruž
You can't see any such thing.

>take ruž
You can't see any such thing.

* * *

DPProjektTeaJelavic
An Interactive Fiction by Tea Jelavic
Release 1 / Serial number 230109 / Inform 7 build 6M62 (I6/v6.33 lib 6/12N) SD

Prvi kat
Dobrodošli u Shopping kraljicu i City Centar. Vaš shopping može započeti! Nalazite se na prvom katu. Na prvom se katu nalaze drogerije. Istočno je Dm, a zapadno Bipa. Ako želite ići na drugi kat, popnite se skalama sjeverno, a za izlaz iz centra idite na jug. Za početak pročitajte Vaš zadatak na Shopping kraljica info pultu.

You can see Shopping kraljica info pult here.

>look at info kutija
Vaš zadatak je osmisliti i kupiti novogodišnji look za kućni party kod Vaših prijatelja, makeup, outfit i prigodne cipele. Raspolažete s fondom od 250 €. Otvorite kutiju da biste ga preuzeli. Sretno :) !

>open info kutija
You open Shopping kraljica info kutija, revealing Fond.

>take fond
Taken.

>look at fond
250 €.

* * *

DPProjektTeaJelavic
An Interactive Fiction by Tea Jelavic
Release 1 / Serial number 230109 / Inform 7 build 6M62 (I6/v6.33 lib 6/12N) SD

Prvi kat
Dobrodošli u Shopping kraljicu i City Centar. Vaš shopping može započeti! Nalazite se na prvom katu. Na prvom se katu nalaze drogerije. Istočno je Dm, a zapadno Bipa. Ako želite ići na drugi kat, popnite se skalama sjeverno, a za izlaz iz centra idite na jug. Za početak pročitajte Vaš zadatak na Shopping kraljica info pultu.

You can see Shopping kraljica info pult here.

>look at kutija
Vaš zadatak je osmisliti i kupiti novogodišnji look za kućni party kod Vaših prijatelja. To jest prigodan makeup, outfit i cipele. Raspolažete s fondom od 250 €. Otvorite kutiju da biste ga preuzeli. Sretno :) !

>open kutija
You open Shopping kraljica info kutija, revealing Fond.

* * *

>look at fond
250 €.

>e
Dm
Ušli ste u dućan Dm.

You can see Sjajilo and Labelo here.

* * *

>take labelo
Taken.

>take sjajilo
Moraš prvo platiti sjajilo na kasi!

>inventory
You are carrying:
  Labelo
  Fond

>look at kasa
Pozdrav. Molim Vas stavite svoj artikl na kasu da vam ga mogu naplatiti.

>put labelo on kasa
Račun je je 3.2 €. Molim Vas dajte mi novac.

>put fond on kasa
Hvala Vam na kupnji i doviđenja.

>look at fond
fond-3.2€.

>inventory
You are carrying:
  Labelo
  Fond

* * *

DPProjektTeaJelavic
An Interactive Fiction by Tea Jelavic
Release 1 / Serial number 230109 / Inform 7 build 6M62 (I6/v6.33 lib 6/12N) SD

Prvi kat
Dobrodošli u Shopping kraljicu i City Centar. Vaš shopping može započeti! Nalazite se na prvom katu. Na prvom se katu nalaze drogerije. Istočno je Dm, a zapadno Bipa. Ako želite ići na drugi kat, popnite se skalama sjeverno, a za izlaz iz centra idite na jug. Za početak pročitajte Vaš zadatak na Shopping kraljica info pultu.

You can see Shopping kraljica info pult here.

>open kutija
You can't see any such thing.

>take fond
You can't see any such thing.

>e
Dm
Ušli ste u dućan Dm.

You can see Sjajilo and Labelo here.

>take labelo
Moraš prvo platiti labelo na kasi!

Taken.

* * *

>take sjajilo
Moraš prvo platiti sjajilo na kasi!

>put sjajilo on kasa
Račun za sjajilo je 15 €. Molim Vas stavite fond na kasu.

>put fond on kasa
Hvala Vam na kupnji i doviđenja, preostalo Vam je još 235 €.

>put labelo on kasa
Račun za labelo je 3 €. Molim Vas stavite fond na kasu.

>put fond on kasa
Hvala Vam na kupnji i doviđenja, preostalo Vam je još 220 €.

>inventory
You are carrying:
  Fond

>take sjajilo
Taken.

>take labelo
Moraš prvo platiti labelo na kasi!

* * *

>e
Dm
Ušli ste u dućan Dm.

You can see Sjajilo and Labelo here.

>put sjajilo on kasa
Račun za sjajilo je 15 €. Molim Vas stavite fond na kasu.

>put fond on kasa
Hvala Vam na kupnji i doviđenja. Ne zaboravite uzeti sjajilo. Preostalo Vam je još 247 €.

>put labelo on kasa
Račun za labelo je 3 €. Molim Vas stavite fond na kasu.

>put fond on kasa
Hvala Vam na kupnji i doviđenja. Ne zaboravite uzeti labelo. Preostalo Vam je još 242 €.

>put fond on kasa
Hvala Vam na kupnji i doviđenja. Ne zaboravite uzeti labelo. Preostalo Vam je još 237 €.

* * *

>e
Dm
Ušli ste u dućan Dm.

You can see Sjajilo and Labelo here.

>put fond on kasa
Nemate ništa za platiti.

>put sjajilo on kasa
Račun za sjajilo je 15 €. Molim Vas stavite fond na kasu.

>put fond on kasa
Hvala Vam na kupnji i doviđenja. Ne zaboravite uzeti sjajilo. Preostalo Vam je još 235 €.
Ništa niste stavili na kasu za kupiti, stoga nemate ništa ni za platiti.

* * *

>put fond on kasa
Nemate ništa za platiti.

>take labelo
Moraš prvo platiti labelo na kasi!

>put labelo on kasa
Račun za labelo je 3 €. Molim Vas stavite fond na kasu.

>put fond on kasa
Hvala Vam na kupnji i doviđenja. Ne zaboravite uzeti labelo. Preostalo Vam je još 247 €.

>look fond
247 €

>put fond on kasa
Nemate ništa za platiti.

>take labelo
Taken.

* * *

>put sjajilo on kasa
Račun za sjajilo je 15 €. Molim Vas stavite fond na kasu.

>put fond on kasa
Hvala Vam na kupnji i doviđenja. Ne zaboravite uzeti sjajilo. Preostalo Vam je još 232 €.

>put fond on kasa
Nemate ništa za platiti.

>take sjajilo
Taken.

>inventory
You are carrying:
  Sjajilo
  Labelo
  Fond

>put sjajilo on kasa
Račun za sjajilo je 15 €. Molim Vas stavite fond na kasu.

>put fond on kasa
Hvala Vam na kupnji i doviđenja. Ne zaboravite uzeti sjajilo. Preostalo Vam je još 217 €.

* * *

>take fond
You can't see any such thing.

>look fondć
You can't see any such thing.

>look fond
250 €.

* * *

>take sjajilo
Moraš prvo platiti sjajilo na kasi!

I beg your pardon?

>look kasa
Pozdrav. Molim Vas stavite svoj artikl na kasu da vam ga mogu naplatiti.

>put sjajilo on kasa
Račun je je 15 €. Molim Vas stavite fond na kasu.

>put fond on kasa
Hvala Vam na kupnji i doviđenja, preostalo Vam je još 235 €.

* * *

>take fond
You can't see any such thing.

>look fond
250 €.

* * *

>e
Dm
Ušli ste u dućan Dm.

You can see Sjajilo and Labelo here.

>put fond on kasa
Ništa niste stavili na kasu za kupiti, stoga nemate ništa ni za platiti.

>take sjajilo
Moraš prvo platiti sjajilo na kasi!

* * *

>look kasa
Pozdrav. Molim Vas stavite svoj artikl na kasu da vam ga mogu naplatiti.

>put sjajilo on kasa
Račun za sjajilo je 15 €. Molim Vas stavite fond na kasu.

>put fond on kasa
Ništa niste stavili na kasu za kupiti, stoga nemate ništa ni za platiti.

* * *

>take fond
You can't see any such thing.

>put fond on kasa
You can't see any such thing.

>put sjajilo on kasa
You can't see any such thing.

>e
Dm
Ušli ste u dućan Dm.

You can see Sjajilo and Labelo here.

* * *

I beg your pardon?

>put sjajilo on kasa
Račun za sjajilo je 15 €. Molim Vas stavite fond na kasu.

>put fond on kasa
Hvala Vam na kupnji i doviđenja. Ne zaboravite uzeti sjajilo. Preostalo Vam je još 235 €.

* * *

>take fond
You can't see any such thing.

>open koverta
You open Koverta, revealing Fond.

* * *

>take fond
Taken.

>press gumb
Pritisli ste gumb završetka što znači da ste završili svoj shopping. Vaš novogodišnji party look se satoji od Fond.
Nažalost, niste uspješno savladali današnji Shopping kraljica zadatak. Više sreće drugi put!

* * *

>e
Dm
Ušli ste u dućan Dm.

You can see Sjajilo and Labelo here.

>put labelo on kasa
Račun za labelo je 3 €. Molim Vas stavite fond na kasu.

>put fond on kasa
Hvala Vam na kupnji i doviđenja. Ne zaboravite uzeti labelo. Preostalo Vam je još 197 €.

>w
Prvi kat
Nalazite se na prvom katu. Na prvom se katu nalaze drogerije. Istočno je Dm, a zapadno Bipa. Ako želite ići na drugi kat, popnite se skalama sjeverno, a za izlaz iz centra idite na jug.

You can see Shopping kraljica info pult here.

>press gumb
Pritisli ste gumb završetka što znači da ste završili svoj shopping. Vaš novogodišnji party look se sastoji od Fond.
Nažalost, niste uspješno savladali novogodišnji Shopping kraljica zadatak. Više sreće drugi put!

* * *

>open kutija
You can't see any such thing.

>take fondć
You can't see any such thing.

>take fond
Taken.

* * *

DPProjektTeaJelavic
An Interactive Fiction by Tea Jelavic
Release 1 / Serial number 230109 / Inform 7 build 6M62 (I6/v6.33 lib 6/12N) SD

Prvi kat
Dobrodošli u Shopping kraljicu i City Centar. Vaš shopping može započeti! Nalazite se na prvom katu. Na prvom se katu nalaze drogerije. Istočno je Dm, a zapadno Bipa. Ako želite ići na drugi kat, popnite se skalama sjeverno, a za izlaz iz centra idite na jug. Za početak pročitajte Vaš zadatak na Shopping kraljica info pultu.

You can see Shopping kraljica info pult here.

>w
Bipa
Ušli ste u dućan Bipa.

On Bipa kasa is Bipa kupon s popustom od 5 eura.

You can also see Maskara and Sjenilo here.

>n
You can't go that way.

>n
You can't go that way.

>e
Prvi kat
Dobrodošli u Shopping kraljicu i City Centar. Vaš shopping može započeti! Nalazite se na prvom katu. Na prvom se katu nalaze drogerije. Istočno je Dm, a zapadno Bipa. Ako želite ići na drugi kat, popnite se skalama sjeverno, a za izlaz i centra idite na jug.

Za početak pročitajte Vaš zadatak na Shopping kraljica info kutiji.

>n
Skale12
Vozite se pokretnim skalama. Idite gore ako se želite popeti ili dole ako se želite spustiti.

* * *

>n
Drugi kat
Popeli ste se na drugi kat. Na drugom se katu nalaze trgovine s odjećom. Istočno je Zara, a zapadno Mango. Ako želite ići na treći kat, popnite se skalama sjeverno, a ako želite ići na prvi kat idite na jug.

>e
Zara
Ušli ste u dućan Zara.

On Zara kasa is Zara kupon s popustom od 7.

You can also see Hlace and Haljina here.

* * *

>w
Bipa
Ušli ste u dućan Bipa.

On Bipa kasa is Bipa kupon s popustom od 5 eura.

You can also see Maskara and Sjenilo here.

>take maskara
Taken.

* * *

DPProjektTeaJelavic
An Interactive Fiction by Tea Jelavic
Release 1 / Serial number 230109 / Inform 7 build 6M62 (I6/v6.33 lib 6/12N) SD

Prvi kat
Dobrodošli u Shopping kraljicu i City Centar. Vaš shopping može započeti! Nalazite se na prvom katu. Na prvom se katu nalaze drogerije. Istočno je Dm, a zapadno Bipa. Ako želite ići na drugi kat, popnite se skalama sjeverno, a za izlaz iz centra idite na jug. Za početak pročitajte Vaš zadatak na Shopping kraljica info pultu.

You can see Shopping kraljica info pult here.

>look at Z
You can't see any such thing.

* * *

DPProjektTeaJelavic
An Interactive Fiction by Tea Jelavic
Release 1 / Serial number 230109 / Inform 7 build 6M62 (I6/v6.33 lib 6/12N) SD

Prvi kat
Dobrodošli u Shopping kraljicu i City Centar. Vaš shopping može započeti! Nalazite se na prvom katu. Na prvom se katu nalaze drogerije. Istočno je Dm, a zapadno Bipa. Ako želite ići na drugi kat, popnite se skalama sjeverno, a za izlaz iz centra idite na jug. Za početak pročitajte Vaš zadatak na Shopping kraljica info pultu.

You can see Shopping kraljica info pult here.

>Z
Time passes.

* * *

DPProjektTeaJelavic
An Interactive Fiction by Tea Jelavic
Release 1 / Serial number 230109 / Inform 7 build 6M62 (I6/v6.33 lib 6/12N) SD

Prvi kat
Dobrodošli u Shopping kraljicu i City Centar. Vaš shopping može započeti! Nalazite se na prvom katu. Na prvom se katu nalaze drogerije. Istočno je Dm, a zapadno Bipa. Ako želite ići na drugi kat, popnite se skalama sjeverno, a za izlaz iz centra idite na jug. Za početak pročitajte Vaš zadatak na Shopping kraljica info pultu.

You can see Shopping kraljica info pult here.

>decide X
That's not a verb I recognise.

>say X
(to yourself)
There is no reply.

>say Z
(to yourself)
There is no reply.

>Z
Time passes.

>x minus y
You can't see any such thing.

* * *

DPProjektTeaJelavic
An Interactive Fiction by Tea Jelavic
Release 1 / Serial number 230109 / Inform 7 build 6M62 (I6/v6.33 lib 6/12N) SD

Prvi kat
Dobrodošli u Shopping kraljicu i City Centar. Vaš shopping može započeti! Nalazite se na prvom katu. Na prvom se katu nalaze drogerije. Istočno je Dm, a zapadno Bipa. Ako želite ići na drugi kat, popnite se skalama sjeverno, a za izlaz iz centra idite na jug. Za početak pročitajte Vaš zadatak na Shopping kraljica info pultu.

You can see Shopping kraljica info pult here.

>look info kutija
Vaš zadatak je osmisliti i kupiti novogodišnji look za kućni party kod Vaših prijatelja. To jest prigodan makeup, outfit i cipele. Raspolažete s fondom od 250 €. Otvorite kutiju da biste ga preuzeli. Sretno :) !

* * *

DPProjektTeaJelavic
An Interactive Fiction by Tea Jelavic
Release 1 / Serial number 230109 / Inform 7 build 6M62 (I6/v6.33 lib 6/12N) SD

Prvi kat
Dobrodošli u Shopping kraljicu i City Centar. Vaš shopping može započeti! Nalazite se na prvom katu. Na prvom se katu nalaze drogerije. Istočno je Dm, a zapadno Bipa. Ako želite ići na drugi kat, popnite se skalama sjeverno, a za izlaz iz centra idite na jug. Za početak pročitajte Vaš zadatak na Shopping kraljica info pultu.

You can see Shopping kraljica info pult here.

>look kutija
Vaš zadatak je osmisliti i kupiti novogodišnji look za kućni party kod Vaših prijatelja. To jest prigodan makeup, outfit i cipele. Raspolažete s fondom od 250 €. Otvorite kutiju da biste ga preuzeli. Sretno :) !

>open kutija
You open Shopping kraljica info kutija, revealing Fond.

* * *

>take fond
Taken.

>take fond
Već ste preuzeli svoj fond

>drop fond
Dropped.

>take fond
Već ste preuzeli svoj fond

* * *

DPProjektTeaJelavic
An Interactive Fiction by Tea Jelavic
Release 1 / Serial number 230109 / Inform 7 build 6M62 (I6/v6.33 lib 6/12N) SD

Prvi kat
Dobrodošli u Shopping kraljicu i City Centar. Vaš shopping može započeti! Nalazite se na prvom katu. Na prvom se katu nalaze drogerije. Istočno je Dm, a zapadno Bipa. Ako želite ići na drugi kat, popnite se skalama sjeverno, a za izlaz iz centra idite na jug. Za početak pročitajte Vaš zadatak na Shopping kraljica info pultu.

You can see Shopping kraljica info pult here.

>look info pult
Vaš zadatak je osmisliti i kupiti novogodišnji look za kućni party kod Vaših prijatelja. To jest: prigodan makeup, outfit i cipele. Raspolažete s fondom od 200 €. Ispred vas se nalazi koverta u kojoj se on nalazi. Otvorite je i uzmite i preuzmite svoj fond.  Kada završite sa svojim shoppingom, vratite se do ovog info pulta i pritisnite gumb završetka. Sretno :) !

>look koverta
Otvori me i preuzmi svoj fond.

>open koverta
You open Koverta, revealing Fond.

>look fond
250 €.

>take fond
Taken.

* * *

>e
Dm
Ušli ste u dućan Dm.

You can see Sjajilo and Labelo here.

>look sjajilo
Loreal Nude princess 213 gloss, 15 €.

>look sjenilo
You can't see any such thing.

>look labelo
Balea Pink rose lip balm, 3 €.

>take labelo
Moraš prvo platiti labelo na kasi!

>look kasa
Pozdrav. Molim Vas stavite svoj artikl na kasu da vam ga mogu naplatiti.

>put labelo on kasa
Račun za labelo je 3 €. Molim Vas stavite fond na kasu.

* * *

>put fond on kasa
Hvala Vam na kupnji i doviđenja. Ne zaboravite uzeti labelo. Preostalo Vam je još 247 €.

>w
Prvi kat
Dobrodošli u Shopping kraljicu i City Centar. Vaš shopping može započeti! Nalazite se na prvom katu. Na prvom se katu nalaze drogerije. Istočno je Dm, a zapadno Bipa. Ako želite ići na drugi kat, popnite se skalama sjeverno, a za izlaz iz centra idite na jug.

Za početak pročitajte Vaš zadatak na Shopping kraljica info pultu.

>n
Skale12
Vozite se pokretnim skalama. Idite gore ako se želite popeti ili dole ako se želite spustiti.

* * *

>look sjajilo
Loreal Nude princess 213 gloss, 15 €.

>look labelo
Balea Pink rose lip balm, 3 €.

* * *

>put fond on kasa
Hvala Vam na kupnji i doviđenja. Ne zaboravite uzeti labelo. Preostalo Vam je još 247 €.

>take labelo
Taken.

>inventory
You are carrying:
  Labelo
  Fond

>w
Prvi kat
Nalazite se na prvom katu. Na prvom se katu nalaze drogerije. Istočno je Dm, a zapadno Bipa. Ako želite ići na drugi kat, popnite se skalama sjeverno, a za izlaz iz centra idite na jug.

Za početak pročitajte Vaš zadatak na Shopping kraljica info pultu.

* * *

>look info pult
Vaš zadatak je osmisliti i kupiti novogodišnji look za kućni party kod Vaših prijatelja. To jest: prigodan makeup, outfit i cipele. Raspolažete s fondom od 200 €. Ispred vas se nalazi koverta u kojoj se on nalazi. Otvorite je i uzmite i preuzmite svoj fond.  Kada završite sa svojim shoppingom, vratite se do ovog info pulta i pritisnite gumb završetka. Sretno :) !

>take fond
You can't see any such thing.

* * *

>look info pult
Vaš zadatak je osmisliti i kupiti novogodišnji look za kućni party kod Vaših prijatelja. To jest: prigodan makeup, outfit i cipele. Raspolažete s fondom od 200 €. Ispred vas se nalazi koverta u kojoj se on nalazi. Otvorite je i uzmite i preuzmite svoj fond.  Kada završite sa svojim shoppingom, vratite se do ovog info pulta i pritisnite gumb završetka. Sretno :) !

>open koverta
You open Koverta, revealing Fond.

* * *

>take fond
Taken.

>look fond
200 €.

>e
Dm
Ušli ste u dućan Dm.

You can see Sjajilo and Labelo here.

* * *

>take labelo
Taken.

>w
Prvi kat
Nalazite se na prvom katu. Na prvom se katu nalaze drogerije. Istočno je Dm, a zapadno Bipa. Ako želite ići na drugi kat, popnite se skalama sjeverno, a za izlaz iz centra idite na jug.

>n
Skale12
Vozite se pokretnim skalama. Idite gore ako se želite popeti ili dole ako se želite spustiti.

* * *

>n
Drugi kat
Popeli ste se na drugi kat. Na drugom se katu nalaze trgovine s odjećom. Istočno je Zara, a zapadno Mango. Ako želite ići na treći kat, popnite se skalama sjeverno, a ako želite ići na prvi kat idite na jug.

>w
Mango
Ušli ste u dućan Mango.

You can see Kosulja and Minica here.

>take minica
Moraš prvo platiti minicu na kasi!

>put minica on kasa
Račun za kosulju je 32 €. Molim Vas stavite fond na kasu.

* * *

>look fond
200 €.

>n
Skale12
Vozite se pokretnim skalama. Idite gore ako se želite popeti ili dole ako se želite spustiti.

* * *

>s
Skale12
Vozite se pokretnim skalama. Idite gore ako se želite popeti ili dole ako se želite spustiti.

>s
Prvi kat
Nalazite se na prvom katu. Na prvom se katu nalaze drogerije. Istočno je Dm, a zapadno Bipa. Ako želite ići na drugi kat, popnite se skalama sjeverno, a za izlaz iz centra idite na jug.

You can see Shopping kraljica info pult here.

>n
Skale12
Vozite se pokretnim skalama. Idite gore ako se želite popeti ili dole ako se želite spustiti.

* * *

>n
Treci kat
Popeli ste se na treći kat. Na trecem se katu nalaze trgovine s obućom. Istočno je Shooster, sjeverno Mass, a zapadno Buzz. Ako želite ići na drug kat idite na jug.

Na sredini se nalazi kutija iznenađenja.

>s
Skale23
Vozite se pokretnim skalama. Idite gore ako se želite popeti ili dole ako se želite spustiti.

* * *

>s
Drugi kat
Popeli ste se na drugi kat. Na drugom se katu nalaze trgovine s odjećom. Istočno je Zara, a zapadno Mango. Ako želite ići na treći kat, popnite se skalama sjeverno, a ako želite ići na prvi kat idite na jug.

>e
Zara
Ušli ste u dućan Zara.

You can see Hlace and Haljina here.

>w
Drugi kat
Popeli ste se na drugi kat. Na drugom se katu nalaze trgovine s odjećom. Istočno je Zara, a zapadno Mango. Ako želite ići na treći kat, popnite se skalama sjeverno, a ako želite ići na prvi kat idite na jug.

* * *

>s
Prvi kat
Nalazite se na prvom katu. Na prvom se katu nalaze drogerije. Istočno je Dm, a zapadno Bipa. Ako želite ići na drugi kat, popnite se skalama sjeverno, a za izlaz iz centra idite na jug.

You can see Shopping kraljica info pult here.

>e
Dm
Ušli ste u dućan Dm.

You can see Sjajilo and Labelo here.

* * *

>put sjajilo on kasa
Račun za sjajilo je 15 €. Molim Vas stavite fond na kasu.

>w
Prvi kat
Nalazite se na prvom katu. Na prvom se katu nalaze drogerije. Istočno je Dm, a zapadno Bipa. Ako želite ići na drugi kat, popnite se skalama sjeverno, a za izlaz iz centra idite na jug.

You can see Shopping kraljica info pult here.

>e
Dm
Ušli ste u dućan Dm.

You can see Sjajilo and Labelo here.

* * *

>look sjajilo
Loreal Nude princess 213 gloss, 15 €.

>take sjajilo
Moraš prvo platiti sjajilo na kasi!

* * *

>put sjajilo on kasa
Račun za sjajilo je 15 €. Molim Vas stavite fond na kasu.

>put fond on kasa
Hvala Vam na kupnji i doviđenja. NE ZABORAVITE uzeti sjajilo! Preostalo Vam je još 185 €.

>take sjajilo
Taken.

>w
Prvi kat
Nalazite se na prvom katu. Na prvom se katu nalaze drogerije. Istočno je Dm, a zapadno Bipa. Ako želite ići na drugi kat, popnite se skalama sjeverno, a za izlaz iz centra idite na jug.

You can see Shopping kraljica info pult here.

>n
Skale12
Vozite se pokretnim skalama. Idite gore ako se želite popeti ili dole ako se želite spustiti.

* * *

>w
Mango
Ušli ste u dućan Mango.

You can see Kosulja and Minica here.

>put minica on kasa
Račun za minicu je 32 €. Molim Vas stavite fond na kasu.

>put fond on kasa
Hvala Vam na kupnji i doviđenja. Ne zaboravite uzeti minicu. Preostalo Vam je još 165 €.

>e
Drugi kat
Popeli ste se na drugi kat. Na drugom se katu nalaze trgovine s odjećom. Istočno je Zara, a zapadno Mango. Ako želite ići na treći kat, popnite se skalama sjeverno, a ako želite ići na prvi kat idite na jug.

>s
Skale12
Vozite se pokretnim skalama. Idite gore ako se želite popeti ili dole ako se želite spustiti.

* * *

>s
Prvi kat
Nalazite se na prvom katu. Na prvom se katu nalaze drogerije. Istočno je Dm, a zapadno Bipa. Ako želite ići na drugi kat, popnite se skalama sjeverno, a za izlaz iz centra idite na jug.

You can see Shopping kraljica info pult here.

>press gumb
Pritisli ste gumb završetka što znači da ste završili svoj shopping. Vaš novogodišnji party look se sastoji od Fond.
Nažalost, niste uspješno savladali novogodišnji Shopping kraljica zadatak. Više sreće drugi put!

>n
Skale12
Vozite se pokretnim skalama. Idite gore ako se želite popeti ili dole ako se želite spustiti.

* * *

>w
Mango
Ušli ste u dućan Mango.

You can see Kosulja and Minica here.

>put kosulja on kasa
Račun za kosulju je 23 €. Molim Vas stavite fond na kasu.

>put fond on kasa
Hvala Vam na kupnji i doviđenja. Ne zaboravite uzeti kosulju. Preostalo Vam je još 142 €.

>n
You can't go that way.

>w
You can't go that way.

>e
Drugi kat
Popeli ste se na drugi kat. Na drugom se katu nalaze trgovine s odjećom. Istočno je Zara, a zapadno Mango. Ako želite ići na treći kat, popnite se skalama sjeverno, a ako želite ići na prvi kat idite na jug.

>n
Skale23
Vozite se pokretnim skalama. Idite gore ako se želite popeti ili dole ako se želite spustiti.

* * *

>n
Treci kat
Popeli ste se na treći kat. Na trecem se katu nalaze trgovine s obućom. Istočno je Shooster, sjeverno Mass, a zapadno Buzz. Ako želite ići na drug kat idite na jug.

Na sredini se nalazi kutija iznenađenja.

>w
Buzz
Ušli ste u dućan Buzz.

You can see Puma natikace and Champion natikace here.

>put champion on kasa
Račun za Champion natikace je 43 €. Molim Vas stavite fond na kasu.

>take champion
Moraš prvo platiti Champion natikače na kasi!

>put fond on kasa
Hvala Vam na kupnji i doviđenja. Ne zaboravite uzeti Champion natikače. Preostalo Vam je još 99 €.

>e
Treci kat
Popeli ste se na treći kat. Na trecem se katu nalaze trgovine s obućom. Istočno je Shooster, sjeverno Mass, a zapadno Buzz. Ako želite ići na drug kat idite na jug.

Na sredini se nalazi kutija iznenađenja.

>s
Skale23
Vozite se pokretnim skalama. Idite gore ako se želite popeti ili dole ako se želite spustiti.

* * *

>look info pult
Vaš zadatak je osmisliti i kupiti novogodišnji look za kućni party kod Vaših prijatelja. To jest: prigodan makeup, outfit i cipele. Raspolažete s fondom od 200 €. Ispred vas se nalazi koverta u kojoj se on nalazi. Otvorite je i uzmite i preuzmite svoj fond.  Kada završite sa svojim shoppingom, vratite se do ovog info pulta i pritisnite gumb završetka. Sretno :) !

>look gumb
Pritisni me na kraju shoppinga!

I beg your pardon?

>press gumb
It is fixed in place.

* * *

DPProjektTeaJelavic
An Interactive Fiction by Tea Jelavic
Release 1 / Serial number 230109 / Inform 7 build 6M62 (I6/v6.33 lib 6/12N) SD

Prvi kat
Dobrodošli u Shopping kraljicu i City Centar. Vaš shopping može započeti! Nalazite se na prvom katu. Na prvom se katu nalaze drogerije. Istočno je Dm, a zapadno Bipa. Ako želite ići na drugi kat, popnite se skalama sjeverno, a za izlaz iz centra idite na jug. Za početak pročitajte Vaš zadatak na Shopping kraljica info pultu.

You can see Shopping kraljica info pult here.

>opne koverta
That's not a verb I recognise.

>open koverta
You open Koverta, revealing Fond.

* * *

>e
Dm
Ušli ste u dućan Dm.

You can see Sjajilo and Labelo here.

>w
Prvi kat
Nalazite se na prvom katu. Na prvom se katu nalaze drogerije. Istočno je Dm, a zapadno Bipa. Ako želite ići na drugi kat, popnite se skalama sjeverno, a za izlaz iz centra idite na jug.

Za početak pročitajte Vaš zadatak na Shopping kraljica info pultu.

* * *

>take fond
Taken.

>n
Skale12
Vozite se pokretnim skalama. Idite gore ako se želite popeti ili dole ako se želite spustiti.

* * *

>take bon
Taken.

>look fond
260 €

>take fond
Već ste preuzeli svoj fond!

You already have that.

>drop fond
Dropped.

>take fond
Već ste preuzeli svoj fond!

Taken.

>look fond
260 €

* * *

DPProjektTeaJelavic
An Interactive Fiction by Tea Jelavic
Release 1 / Serial number 230109 / Inform 7 build 6M62 (I6/v6.33 lib 6/12N) SD

Prvi kat
Dobrodošli u Shopping kraljicu i City Centar. Vaš shopping može započeti! Nalazite se na prvom katu. Na prvom se katu nalaze drogerije. Istočno je Dm, a zapadno Bipa. Ako želite ići na drugi kat, popnite se skalama sjeverno, a za izlaz iz centra idite na jug. Za početak pročitajte Vaš zadatak na Shopping kraljica info pultu.

You can see Shopping kraljica info pult here.

>open koverta
You open Koverta, revealing Fond.

* * *

>take fond
Već ste preuzeli svoj fond

>e
Dm
Ušli ste u dućan Dm.

You can see Sjajilo and Labelo here.

* * *

>put labelo on kasa
Račun za labelo je 3 €. Molim Vas stavite fond na kasu.

>put fond on kasa
You can't see any such thing.

* * *

>look fond
200 €.

>drop fond
Dropped.

>inventory
You are carrying nothing.

>look fond
250 €.

>take fond
Već ste preuzeli svoj fond
Taken.

* * *

>drop fond
Dropped.

>look fond
250 €.

>inventory
You are carrying nothing.

>take fond
Već ste preuzeli svoj fond!

Taken.

>look fond
250 €.

>inventory
You are carrying:
  Fond

>n
Skale12
Vozite se pokretnim skalama. Idite gore ako se želite popeti ili dole ako se želite spustiti.

* * *

>take bon
Taken.

>look fond
250 €.

* * *

>drop fond
Dropped.

>take fond
Taken.

>drop fond
Dropped.

>look fond
200 €.

* * *

>n
Drugi kat
Popeli ste se na drugi kat. Na drugom se katu nalaze trgovine s odjećom. Istočno je Zara, a zapadno Mango. Ako želite ići na treći kat, popnite se skalama sjeverno, a ako želite ići na prvi kat idite na jug.

I beg your pardon?

>n
Skale23
Vozite se pokretnim skalama. Idite gore ako se želite popeti ili dole ako se želite spustiti.

* * *

>look fond
You can't see any such thing.

* * *

>s
Skale12
Vozite se pokretnim skalama. Idite gore ako se želite popeti ili dole ako se želite spustiti.

>s
Prvi kat
Nalazite se na prvom katu. Na prvom se katu nalaze drogerije. Istočno je Dm, a zapadno Bipa. Ako želite ići na drugi kat, popnite se skalama sjeverno, a za izlaz iz centra idite na jug.

You can see Fond and Shopping kraljica info pult here.

>e
Dm
Ušli ste u dućan Dm.

You can see Sjajilo and Labelo here.

>put fond on kasa
You can't see any such thing.

>w
Prvi kat
Nalazite se na prvom katu. Na prvom se katu nalaze drogerije. Istočno je Dm, a zapadno Bipa. Ako želite ići na drugi kat, popnite se skalama sjeverno, a za izlaz iz centra idite na jug.

You can see Fond and Shopping kraljica info pult here.

>take fond
Taken.

>look fond
210 €

>e
Dm
Ušli ste u dućan Dm.

You can see Sjajilo and Labelo here.

* * *

>n
Drugi kat
Popeli ste se na drugi kat. Na drugom se katu nalaze trgovine s odjećom. Istočno je Zara, a zapadno Mango. Ako želite ići na treći kat, popnite se skalama sjeverno, a ako želite ići na prvi kat idite na jug.

>nnž
That's not a verb I recognise.

>n
Skale23
Vozite se pokretnim skalama. Idite gore ako se želite popeti ili dole ako se želite spustiti.

* * *

>look fond
200 €.

>w
Bipa
Ušli ste u dućan Bipa.

You can see Maskara and Sjenilo here.

>put fond on kasa
Nemate ništa za platiti.

>put sjenilo on kasa
Račun za sjenilo je 20 €. Molim Vas stavite fond na kasu.

>put fond on kasa
Nemate ništa za platiti.

>w
You can't go that way.

>e
Prvi kat
Nalazite se na prvom katu. Na prvom se katu nalaze drogerije. Istočno je Dm, a zapadno Bipa. Ako želite ići na drugi kat, popnite se skalama sjeverno, a za izlaz iz centra idite na jug.

>e
Dm
Ušli ste u dućan Dm.

You can see Sjajilo and Labelo here.

* * *

>put fond on kasa
Nemate ništa za platiti.

>put labelo on kasa
Račun za labelo je 3 €. Molim Vas stavite fond na kasu.

* * *

>put fond on kasa
Hvala Vam na kupnji i doviđenja. Ne zaboravite uzeti labelo. Preostalo Vam je još 247 €.

>put sjajilo on kasa
Račun za sjajilo je 15 €. Molim Vas stavite fond na kasu.

* * *

>put fond on kasa
Hvala Vam na kupnji i doviđenja. Ne zaboravite uzeti sjajilo. Preostalo Vam je još 232 €.

>take sjajilo
Taken.

>take labelo
Taken.

>put fond on kasa
Nemate ništa za platiti.

>w
Prvi kat
Nalazite se na prvom katu. Na prvom se katu nalaze drogerije. Istočno je Dm, a zapadno Bipa. Ako želite ići na drugi kat, popnite se skalama sjeverno, a za izlaz iz centra idite na jug.

* * *

>put fond on kasa
Nemate ništa za platiti.

>put maskara on kasa
Račun za maskaru je 32 €. Molim Vas stavite fond na kasu.

>put fond on kasa
Nemate ništa za platiti.

* * *

>look fond
250 €.

>take fond
Već ste preuzeli svoj fond

* * *

>take fond
Već ste preuzeli svoj fond!

Taken.

>e
Dm
Ušli ste u dućan Dm.

You can see Sjajilo and Labelo here.

I beg your pardon?

>put labelo on kasa
Račun za labelo je 3 €. Molim Vas stavite fond na kasu.

* * *

>take fond
Već ste preuzeli svoj fond!

Taken.

>w
Bipa
Ušli ste u dućan Bipa.

You can see Maskara and Sjenilo here.

>put maskara on kasa
Račun za maskaru je 32 €. Molim Vas stavite fond na kasu.

* * *

>drop fond
Dropped.

>e
Dm
Ušli ste u dućan Dm.

You can see Sjajilo and Labelo here.

* * *

>put fond on kasa
You can't see any such thing.

>look fond
You can't see any such thing.

>w
Prvi kat
Nalazite se na prvom katu. Na prvom se katu nalaze drogerije. Istočno je Dm, a zapadno Bipa. Ako želite ići na drugi kat, popnite se skalama sjeverno, a za izlaz iz centra idite na jug.

You can see Fond and Shopping kraljica info pult here.

* * *

>take fond
Taken.

>w
Bipa
Ušli ste u dućan Bipa.

You can see Maskara and Sjenilo here.

* * *

>put maskara on kasa
Račun za maskaru je 32 €. Molim Vas stavite fond na kasu.

>put fond on kasa
Hvala Vam na kupnji i doviđenja. Ne zaboravite uzeti maskaru. Preostalo Vam je još 168 €.

I beg your pardon?

>take maskara
Taken.

>e
Prvi kat
Nalazite se na prvom katu. Na prvom se katu nalaze drogerije. Istočno je Dm, a zapadno Bipa. Ako želite ići na drugi kat, popnite se skalama sjeverno, a za izlaz iz centra idite na jug.

You can see Shopping kraljica info pult here.

>n
Skale12
Vozite se pokretnim skalama. Idite gore ako se želite popeti ili dole ako se želite spustiti.

* * *

>e
Zara
Ušli ste u dućan Zara.

You can see Hlace and Haljina here.

>put haljin aon kas
You can't see any such thing.

>put haljina on kasa
Račun za haljinu je 41 €. Molim Vas stavite fond na kasu.

>put fond on kasa
Hvala Vam na kupnji i doviđenja. Ne zaboravite uzeti haljinu. Preostalo Vam je još 127 €.

>take haljina
Taken.

>w
Drugi kat
Popeli ste se na drugi kat. Na drugom se katu nalaze trgovine s odjećom. Istočno je Zara, a zapadno Mango. Ako želite ići na treći kat, popnite se skalama sjeverno, a ako želite ići na prvi kat idite na jug.

* * *

>n
Mass
Ušli ste u dućan Mass.

You can see Salonke and Spagerice here.

>put spagerice on kasa
Račun za spagerice je 31 €. Molim Vas stavite fond na kasu.

>put fond on kasa
Hvala Vam na kupnji i doviđenja. Ne zaboravite uzeti spagerice. Preostalo Vam je još 96 €.

>take spagerice
Taken.

>take salonke
Moraš prvo platiti salonke na kasi!

>inventory
You are carrying:
  Spagerice
  Haljina
  Maskara
  Fond

>s
Treci kat
Popeli ste se na treći kat. Na trecem se katu nalaze trgovine s obućom. Istočno je Shooster, sjeverno Mass, a zapadno Buzz. Ako želite ići na drug kat idite na jug.

Na sredini se nalazi kutija iznenađenja.

>open kutija
You open Kutija iznena enja, revealing Poklon bon od 10 eura.

* * *

>look fond
106 €

>s
Skale23
Vozite se pokretnim skalama. Idite gore ako se želite popeti ili dole ako se želite spustiti.

* * *

>s
Prvi kat
Nalazite se na prvom katu. Na prvom se katu nalaze drogerije. Istočno je Dm, a zapadno Bipa. Ako želite ići na drugi kat, popnite se skalama sjeverno, a za izlaz iz centra idite na jug.

You can see Shopping kraljica info pult here.

>s
Vani
Izašli ste iz City Centra. Jeste li zazavršili Vašu trgovinu? Ako ne, vratite se nazad i trg u dućane, a ako jeste, vratite se do info pulta i pritisnute gumb završetka.

>n
Prvi kat
Nalazite se na prvom katu. Na prvom se katu nalaze drogerije. Istočno je Dm, a zapadno Bipa. Ako želite ići na drugi kat, popnite se skalama sjeverno, a za izlaz iz centra idite na jug.

You can see Shopping kraljica info pult here.

>press gumb
Pritisli ste gumb završetka što znači da ste završili svoj shopping. Vaš novogodišnji party look se sastoji od Spagerice, Haljina and Maskara.

    *** Čestitamo. Kupili ste sve potrebno da u Novu godinu uđete lijepo sređeni. Uspjeli ste ostati u okvirima zadanog fonda i još sačuvati 106 €. Jako nam se sviđa vaš outfit. Vi ste naša novogodišnja Shopping kraljica! ***

Would you like to RESTART, RESTORE a saved game, QUIT or UNDO the last command?

* * *

>e
Zara
Ušli ste u dućan Zara.

You can see Hlace and Haljina here.

>look kasa
Pozdrav. Molim Vas stavite svoj artikl na kasu da vam ga mogu naplatiti.

* * *

>100
That's not a verb I recognise.

* * *

>put kosulja on kasa
Račun za kosulju je 23 €. Molim Vas stavite fond na kasu.

>put minica on kasa
Račun za minicu je 32 €. Molim Vas stavite fond na kasu.

>put fond on kasa
Hvala Vam na kupnji i doviđenja. Ne zaboravite uzeti minicu. Preostalo Vam je još 218 €.

>put kosulja on kasa
Račun za kosulju je 23 €. Molim Vas stavite fond na kasu.

>put fond on kasa
Hvala Vam na kupnji i doviđenja. Ne zaboravite uzeti kosulju. Preostalo Vam je još 195 €.

>take kosulja
Taken.

>take minica
Taken.

>s
You can't go that way.

>w
You can't go that way.

* * *

>s
Skale12
Vozite se pokretnim skalama. Idite gore ako se želite popeti ili dole ako se želite spustiti.

>s
Prvi kat
Nalazite se na prvom katu. Na prvom se katu nalaze drogerije. Istočno je Dm, a zapadno Bipa. Ako želite ići na drugi kat, popnite se skalama sjeverno, a za izlaz iz centra idite na jug.

You can see Gumb zavr etka here.

>look info pult
Vaš zadatak je osmisliti i kupiti novogodišnji look za kućni party kod Vaših prijatelja. To jest: prigodan makeup, outfit i cipele. Raspolažete s fondom od 250 €. Ispred vas se nalazi koverta u kojoj se on nalazi. Otvorite je i uzmite i preuzmite svoj fond.  Kada završite sa svojim shoppingom, vratite se do ovog info pulta i pritisnite gumb završetka. Sretno :) !

>press gumb
Pritisli ste gumb završetka što znači da ste završili svoj shopping. Vaš novogodišnji party look se satoji od Minica, Kosulja and Fond.

* * *

>look fond
210 €

>take poklon bon
You already have that.

* * *

>look fond
210 €

>e
Shooster
Ušli ste u dućan Shooster.

You can see Nike tenisice and Adidas tenisice here.

>put nike on kasa
Račun za Nike tenisice je 150 €. Molim Vas stavite fond na kasu.

>put fond on kasa
Hvala Vam na kupnji i doviđenja. Ne zaboravite uzeti Nike tenisice. Preostalo Vam je još 110 €.

>w
Treci kat
Popeli ste se na treći kat. Na trecem se katu nalaze trgovine s obućom. Istočno je Shooster, sjeverno Mass, a zapadno Buzz. Ako želite ići na drug kat idite na jug.

Na sredini se nalazi kutija iznenađenja.

>w
Buzz
Ušli ste u dućan Buzz.

You can see Puma natikace and Champion natikace here.

>take puma
Moraš prvo platiti Puma natikače na kasi!

>put puma on kasa
Račun za Puma natikace je 55 €. Molim Vas stavite fond na kasu.

>put fond on kasa
Hvala Vam na kupnji i doviđenja. Ne zaboravite uzeti Puma natikače. Preostalo Vam je još 55 €.

>put champion on kasa
Račun za Champion natikace je 43 €. Molim Vas stavite fond na kasu.

>put fond on kasa
Nemate ništa za platiti.

>take champion
Moraš prvo platiti Champion natikače na kasi!

>put champion natikace on kasa
Račun za Champion natikace je 43 €. Molim Vas stavite fond na kasu.

>put fond on kasa
Nemate ništa za platiti.

* * *

>look fond
210 €

>drop fond
Dropped.

* * *

>take fond
Već ste preuzeli svoj fond!

Taken.

>look fond
210 €

>drop bon
You haven't got that.

* * *

>n
Treci kat
Popeli ste se na treći kat. Na trecem se katu nalaze trgovine s obućom. Istočno je Shooster, sjeverno Mass, a zapadno Buzz. Ako želite ići na drug kat idite na jug.

Na sredini se nalazi kutija iznenađenja.

>look fond
250 €.

>open kutija
You open Kutija iznena enja, revealing Poklon bon od 10 eura.

* * *

>take bon
Taken.

>look bon
Poklon bon od 10 €. Uzmi me!

>look fond
250 €.

* * *

>n
Mass
Ušli ste u dućan Mass.

You can see Salonke and Spagerice here.

>take spagerice
Moraš prvo platiti spagerice na kasi!

>put spagerice on kasa
Račun za spagerice je 31 €. Molim Vas stavite fond na kasu.

>put fond on kasa
Hvala Vam na kupnji i doviđenja. Ne zaboravite uzeti spagerice. Preostalo Vam je još 219 €.

>s
Treci kat
Popeli ste se na treći kat. Na trecem se katu nalaze trgovine s obućom. Istočno je Shooster, sjeverno Mass, a zapadno Buzz. Ako želite ići na drug kat idite na jug.

Na sredini se nalazi kutija iznenađenja.

I beg your pardon?

>s
Skale23
Vozite se pokretnim skalama. Idite gore ako se želite popeti ili dole ako se želite spustiti.

* * *

>s
Skale12
Vozite se pokretnim skalama. Idite gore ako se želite popeti ili dole ako se želite spustiti.

>s
Prvi kat
Nalazite se na prvom katu. Na prvom se katu nalaze drogerije. Istočno je Dm, a zapadno Bipa. Ako želite ići na drugi kat, popnite se skalama sjeverno, a za izlaz iz centra idite na jug.

>s
Vani
Izašli ste iz City Centra. Jeste li zadovoljni Vašom trgovinom?

* * *

>n
Drugi kat
Popeli ste se na drugi kat. Na drugom se katu nalaze trgovine s odjećom. Istočno je Zara, a zapadno Mango. Ako želite ići na treći kat, popnite se skalama sjeverno, a ako želite ići na prvi kat idite na jug.

>m
That's not a verb I recognise.

>n
Skale23
Vozite se pokretnim skalama. Idite gore ako se želite popeti ili dole ako se želite spustiti.

* * *

>n
Treci kat
Popeli ste se na treći kat. Na trecem se katu nalaze trgovine s obućom. Istočno je Shooster, sjeverno Mass, a zapadno Buzz. Ako želite ići na drug kat idite na jug.

Na sredini se nalazi kutija iznenađenja.

>e
Shooster
Ušli ste u dućan Shooster.

You can see Nike tenisice and Adidas tenisice here.

>put adidas on kasa
Račun za Adidas tenisice je 112 €. Molim Vas stavite fond na kasu.

>put fond on kasa
Hvala Vam na kupnji i doviđenja. Ne zaboravite uzeti Adidas tenisice. Preostalo Vam je još 138 €.

>w
Treci kat
Popeli ste se na treći kat. Na trecem se katu nalaze trgovine s obućom. Istočno je Shooster, sjeverno Mass, a zapadno Buzz. Ako želite ići na drug kat idite na jug.

Na sredini se nalazi kutija iznenađenja.

* * *

>put champion on kasa
Račun za Champion natikace je 43 €. Molim Vas stavite fond na kasu.

>put fond on kasa
Hvala Vam na kupnji i doviđenja. Ne zaboravite uzeti Champion natikače. Preostalo Vam je još 95 €.

>put puma on kasa
Račun za Puma natikace je 55 €. Molim Vas stavite fond na kasu.

>put fond on kasa
Hvala Vam na kupnji i doviđenja. Ne zaboravite uzeti Puma natikače. Preostalo Vam je još 40 €.

>e
Treci kat
Popeli ste se na treći kat. Na trecem se katu nalaze trgovine s obućom. Istočno je Shooster, sjeverno Mass, a zapadno Buzz. Ako želite ići na drug kat idite na jug.

Na sredini se nalazi kutija iznenađenja.

>open kutija
You open Kutija iznena enja, revealing Poklon bon od 10 eura.

* * *

>take bon
Taken.

>n
Mass
Ušli ste u dućan Mass.

You can see Salonke and Spagerice here.

>take salonke
Moraš prvo platiti salonke na kasi!

>put salonke on kasa
Račun za salonke je 42 €. Molim Vas stavite fond na kasu.

>put fond on kasa
Hvala Vam na kupnji i doviđenja. Ne zaboravite uzeti salonke. Preostalo Vam je još 8 €.

* * *

>put maskara on kasa
Račun za maskaru je 32 €. Molim Vas stavite fond na kasu.

>put fond on kasa
Hvala Vam na kupnji i doviđenja. NE ZABORAVITE uzeti maskaru! Preostalo Vam je još 168 €.

>take maskara
Taken.

>put fond on kasa
Hvala Vam na kupnji i doviđenja. Ne zaboravite uzeti maskaru. Preostalo Vam je još 186 €.

* * *

>take maskara
Taken.

>w
You can't go that way.

>e
Prvi kat
Nalazite se na prvom katu. Na prvom se katu nalaze drogerije. Istočno je Dm, a zapadno Bipa. Ako želite ići na drugi kat, popnite se skalama sjeverno, a za izlaz iz centra idite na jug.

You can see Shopping kraljica info pult here.

* * *

>put minica on kasa
Račun za minicu je 32 €. Molim Vas stavite fond na kasu.

>put fond on kasa
Hvala Vam na kupnji i doviđenja. Ne zaboravite uzeti minicu. Preostalo Vam je još 136 €.

>take minica
Taken.

>put kosulja on kasa
Račun za kosulju je 23 €. Molim Vas stavite fond na kasu.

>put fond on kasa
Hvala Vam na kupnji i doviđenja. Ne zaboravite uzeti kosulju. Preostalo Vam je još 113 €.

>take kosulja
Taken.

>e
Drugi kat
Popeli ste se na drugi kat. Na drugom se katu nalaze trgovine s odjećom. Istočno je Zara, a zapadno Mango. Ako želite ići na treći kat, popnite se skalama sjeverno, a ako želite ići na prvi kat idite na jug.

* * *

>put adidas on kasa
Račun za Adidas tenisice je 112 €. Molim Vas stavite fond na kasu.

>put fond on kasa
Hvala Vam na kupnji i doviđenja. Ne zaboravite uzeti Adidas tenisice. Preostalo Vam je još 1 €.

>w
Treci kat
Popeli ste se na treći kat. Na trecem se katu nalaze trgovine s obućom. Istočno je Shooster, sjeverno Mass, a zapadno Buzz. Ako želite ići na drug kat idite na jug.

Na sredini se nalazi kutija iznenađenja.

>s
Skale23
Vozite se pokretnim skalama. Idite gore ako se želite popeti ili dole ako se želite spustiti.

* * *

>s
Skale12
Vozite se pokretnim skalama. Idite gore ako se želite popeti ili dole ako se želite spustiti.

>n
Drugi kat
Popeli ste se na drugi kat. Na drugom se katu nalaze trgovine s odjećom. Istočno je Zara, a zapadno Mango. Ako želite ići na treći kat, popnite se skalama sjeverno, a ako želite ići na prvi kat idite na jug.

* * *

>open kutija
You open Kutija iznena enja, revealing Poklon bon od 10 eura.

>take fond
Već ste preuzeli svoj fond!

You already have that.

>take bon
Taken.

>s
Skale23
Vozite se pokretnim skalama. Idite gore ako se želite popeti ili dole ako se želite spustiti.

* * *

>s
Prvi kat
Nalazite se na prvom katu. Na prvom se katu nalaze drogerije. Istočno je Dm, a zapadno Bipa. Ako želite ići na drugi kat, popnite se skalama sjeverno, a za izlaz iz centra idite na jug.

You can see Shopping kraljica info pult here.

>press gumb
Pritisli ste gumb završetka što znači da ste završili svoj shopping. Vaš novogodišnji party look se sastoji od Poklon bon od 10 eura, Kosulja, Minica, Maskara and Fond.
Nažalost, niste uspješno savladali novogodišnji Shopping kraljica zadatak. Više sreće drugi put!

>n
Skale12
Vozite se pokretnim skalama. Idite gore ako se želite popeti ili dole ako se želite spustiti.

* * *

>e
Shooster
Ušli ste u dućan Shooster.

You can see Nike tenisice and Adidas tenisice here.

>take adidas
Taken.

>n
You can't go that way.

>s
You can't go that way.

>se
You can't go that way.

>w
Treci kat
Popeli ste se na treći kat. Na trecem se katu nalaze trgovine s obućom. Istočno je Shooster, sjeverno Mass, a zapadno Buzz. Ako želite ići na drug kat idite na jug.

Na sredini se nalazi kutija iznenađenja.

* * *

>s
Prvi kat
Nalazite se na prvom katu. Na prvom se katu nalaze drogerije. Istočno je Dm, a zapadno Bipa. Ako želite ići na drugi kat, popnite se skalama sjeverno, a za izlaz iz centra idite na jug.

You can see Shopping kraljica info pult here.

>press gumb
Pritisli ste gumb završetka što znači da ste završili svoj shopping. Vaš novogodišnji party look se sastoji od Adidas tenisice, Poklon bon od 10 eura, Kosulja, Minica, Maskara and Fond.
Čestitamo. Kupili ste sve potrebno da u Novu godinu uđete lijepo sređeni. Uspjeli ste ostati u okvirima zadanog fonda i još sačuvati 11 €. Jako nam se sviđa vaš outfit. Vi ste naša novogodišnja Shopping kraljica!

* * *

>e
Prvi kat
Nalazite se na prvom katu. Na prvom se katu nalaze drogerije. Istočno je Dm, a zapadno Bipa. Ako želite ići na drugi kat, popnite se skalama sjeverno, a za izlaz iz centra idite na jug.

You can see Shopping kraljica info pult here.

>press gumb
Pritisli ste gumb završetka što znači da ste završili svoj shopping. Vaš novogodišnji party look se sastoji od Maskara.

    *** Nažalost, niste uspješno savladali novogodišnji Shopping kraljica zadatak. Više sreće drugi put! ***

Would you like to RESTART, RESTORE a saved game, QUIT or UNDO the last command?

* * *

>put maskara on kasa
Račun za maskaru je 32 €. Molim Vas stavite fond na kasu.

>put fond on kasa
Hvala Vam na kupnji i doviđenja. Ne zaboravite uzeti maskaru. Preostalo Vam je još 218 €.

>put fond on kasa
Nemate ništa za platiti.

>e
Prvi kat
Nalazite se na prvom katu. Na prvom se katu nalaze drogerije. Istočno je Dm, a zapadno Bipa. Ako želite ići na drugi kat, popnite se skalama sjeverno, a za izlaz iz centra idite na jug.

* * *

>take sjajilo
Moraš prvo platiti sjajilo na kasi!

>look fond
218 €

>put labelo on kasa
Račun za labelo je 3 €. Molim Vas stavite fond na kasu.

>put fond on kasa
Hvala Vam na kupnji i doviđenja. Ne zaboravite uzeti labelo. Preostalo Vam je još 215 €.

>w
Prvi kat
Nalazite se na prvom katu. Na prvom se katu nalaze drogerije. Istočno je Dm, a zapadno Bipa. Ako želite ići na drugi kat, popnite se skalama sjeverno, a za izlaz iz centra idite na jug.

* * *

>w
Bipa
Ušli ste u dućan Bipa.

You can see Maskara and Sjenilo here.

>put sjenilo on kasa
Račun za sjenilo je 20 €. Molim Vas stavite fond na kasu.

>put fond on kasa
Hvala Vam na kupnji i doviđenja. Ne zaboravite uzeti sjenilo. Preostalo Vam je još 195 €.

>look fond
195 €

* * *

>put sjenilo on kasa
Račun za sjenilo je 20 €. Molim Vas stavite fond na kasu.

>put fond on kasa
Hvala Vam na kupnji i doviđenja. Ne zaboravite uzeti sjenilo. Preostalo Vam je još 180 €.

>w
You can't go that way.

* * *

>e
Prvi kat
Nalazite se na prvom katu. Na prvom se katu nalaze drogerije. Istočno je Dm, a zapadno Bipa. Ako želite ići na drugi kat, popnite se skalama sjeverno, a za izlaz iz centra idite na jug.

You can see Shopping kraljica info pult here.

>press gumb
Pritisli ste gumb završetka što znači da ste završili svoj shopping. Vaš novogodišnji party look se sastoji od nothing.
Nažalost, niste uspješno savladali novogodišnji Shopping kraljica zadatak. Više sreće drugi put!

>w
Bipa
Ušli ste u dućan Bipa.

You can see Maskara and Sjenilo here.

>take sjenilo
Taken.

>w
You can't go that way.

* * *

>e
Prvi kat
Nalazite se na prvom katu. Na prvom se katu nalaze drogerije. Istočno je Dm, a zapadno Bipa. Ako želite ići na drugi kat, popnite se skalama sjeverno, a za izlaz iz centra idite na jug.

You can see Shopping kraljica info pult here.

>press gumb
Pritisli ste gumb završetka što znači da ste završili svoj shopping. Vaš novogodišnji party look se sastoji od Sjenilo.
Nažalost, niste uspješno savladali novogodišnji Shopping kraljica zadatak. Više sreće drugi put!

* * *

>put fond on kasa
Hvala Vam na kupnji i doviđenja. NE ZABORAVITE uzeti sjajilo! Preostalo Vam je još 185 €.

I beg your pardon?

>take sjajilo
Taken.

>w
Prvi kat
Nalazite se na prvom katu. Na prvom se katu nalaze drogerije. Istočno je Dm, a zapadno Bipa. Ako želite ići na drugi kat, popnite se skalama sjeverno, a za izlaz iz centra idite na jug.

You can see Gumb zavr etka here.

>n
Skale12
Vozite se pokretnim skalama. Idite gore ako se želite popeti ili dole ako se želite spustiti.

* * *

>put minica on kasa
Račun za minicu je 32 €. Molim Vas stavite fond na kasu.

>put fond on kasa
Hvala Vam na kupnji i doviđenja. Ne zaboravite uzeti minicu. Preostalo Vam je još 203 €.

>take fond
Već ste preuzeli svoj fond!

You already have that.

>take minica
Taken.

>put kosulja on kasa
(first taking Kosulja)
Moraš prvo platiti kosulju na kasi!

>put fond on kasa
Nemate ništa za platiti.

>take kosulja
Moraš prvo platiti kosulju na kasi!

>put kosulja on kasa
(first taking Kosulja)
Moraš prvo platiti kosulju na kasi!

* * *

>put labelo on kasa
Račun za labelo je 3 €. Molim Vas stavite fond na kasu.

>take labelo
Moraš prvo platiti labelo na kasi!

>put fond on kasa
Hvala Vam na kupnji i doviđenja. Ne zaboravite uzeti labelo. Preostalo Vam je još 232 €.

>take labelo
Taken.

* * *

>w
Bipa
Ušli ste u dućan Bipa.

You can see Maskara and Sjenilo here.

>take maskara
Moraš prvo platiti maskaru na kasi!

>put maskara on kasa
Račun za maskaru je 32 €. Molim Vas stavite fond na kasu.

>put fond on kasa
Hvala Vam na kupnji i doviđenja. Ne zaboravite uzeti maskaru. Preostalo Vam je još 200 €.

>take maskara
Taken.

>take sjenilo
Moraš prvo platiti sjenilo na kasi!

>put sjenilo on kasa
Račun za sjenilo je 20 €. Molim Vas stavite fond na kasu.

* * *

>put fond on kasa
Hvala Vam na kupnji i doviđenja. Ne zaboravite uzeti sjenilo. Preostalo Vam je još 180 €.

>e
Prvi kat
Nalazite se na prvom katu. Na prvom se katu nalaze drogerije. Istočno je Dm, a zapadno Bipa. Ako želite ići na drugi kat, popnite se skalama sjeverno, a za izlaz iz centra idite na jug.

* * *

>e
Zara
Ušli ste u dućan Zara.

You can see Hlace and Haljina here.

>take hlace
Moraš prvo platiti hlace na kasi!

>put hlace on kasa
Račun za hlace je 35 €. Molim Vas stavite fond na kasu.

>put fond on kasa
Hvala Vam na kupnji i doviđenja. Ne zaboravite uzeti hlace. Preostalo Vam je još 145 €.

>take hlace
Taken.

>take haljina
Moraš prvo platiti haljinu na kasi!

>put haljina on kasa
Račun za haljinu je 41 €. Molim Vas stavite fond na kasu.

>put fond on kasa
Hvala Vam na kupnji i doviđenja. Ne zaboravite uzeti haljinu. Preostalo Vam je još 104 €.

>w
Drugi kat
Popeli ste se na drugi kat. Na drugom se katu nalaze trgovine s odjećom. Istočno je Zara, a zapadno Mango. Ako želite ići na treći kat, popnite se skalama sjeverno, a ako želite ići na prvi kat idite na jug.

>w
Mango
Ušli ste u dućan Mango.

You can see Kosulja and Minica here.

>take kosulja
Moraš prvo platiti kosulju na kasi!

>put kosulja on kasa
Račun za kosulju je 23 €. Molim Vas stavite fond na kasu.

>put fond on kasa
Hvala Vam na kupnji i doviđenja. Ne zaboravite uzeti kosulju. Preostalo Vam je još 81 €.

>take kosulja
Taken.

>take minica
Moraš prvo platiti minicu na kasi!

>put minica on kasa
Račun za minicu je 32 €. Molim Vas stavite fond na kasu.

>put fond on kasa
Hvala Vam na kupnji i doviđenja. Ne zaboravite uzeti minicu. Preostalo Vam je još 49 €.

>take minica
Taken.

>e
Drugi kat
Popeli ste se na drugi kat. Na drugom se katu nalaze trgovine s odjećom. Istočno je Zara, a zapadno Mango. Ako želite ići na treći kat, popnite se skalama sjeverno, a ako želite ići na prvi kat idite na jug.

* * *

>take bon
Taken.

>look fond
59 €

>e
Shooster
Ušli ste u dućan Shooster.

You can see Nike tenisice and Adidas tenisice here.

>take nike
Moraš prvo platiti Nike tenisice na kasi!

>put nike on kasa
Račun za Nike tenisice je 150 €. Molim Vas stavite fond na kasu.

>put fond on kasa
Nemate dovoljno novaca za kupiti Nike tenisice!

>take adidas
Moraš prvo platiti Adidas tenisice na kasi!

>put adidas on kasa
Račun za Adidas tenisice je 112 €. Molim Vas stavite fond na kasu.

>put fond on kasa
Nemate dovoljno novaca za kupitiAdidas tenisice!

>w
Treci kat
Popeli ste se na treći kat. Na trecem se katu nalaze trgovine s obućom. Istočno je Shooster, sjeverno Mass, a zapadno Buzz. Ako želite ići na drug kat idite na jug.

Na sredini se nalazi kutija iznenađenja.

>open kutija
That's already open.

>take bon
Već ste preuzeli poklon bon
You already have that.

>s
Skale23
Vozite se pokretnim skalama. Idite gore ako se želite popeti ili dole ako se želite spustiti.

* * *

>s
Prvi kat
Nalazite se na prvom katu. Na prvom se katu nalaze drogerije. Istočno je Dm, a zapadno Bipa. Ako želite ići na drugi kat, popnite se skalama sjeverno, a za izlaz iz centra idite na jug.

>open koverta
That's already open.

>take fond
Već ste preuzeli svoj fond!

You already have that.

* * *

>take fond
Već ste preuzeli svoj fond!

Taken.

>look fond
59 €

* * *

>w
Prvi kat
Nalazite se na prvom katu. Na prvom se katu nalaze drogerije. Istočno je Dm, a zapadno Bipa. Ako želite ići na drugi kat, popnite se skalama sjeverno, a za izlaz iz centra idite na jug.

You can see Shopping kraljica info pult here.

>w
Bipa
Ušli ste u dućan Bipa.

You can see Maskara and Sjenilo here.

* * *

>put maskara on kasa
Račun za maskaru je 32 €. Molim Vas stavite fond na kasu.

>put fond on kasa
Hvala Vam na kupnji i doviđenja. NE ZABORAVITE uzeti maskaru! Preostalo Vam je još 153 €.

>take maskara
Taken.

* * *

>w
Drugi kat
Popeli ste se na drugi kat. Na drugom se katu nalaze trgovine s odjećom. Istočno je Zara, a zapadno Mango. Ako želite ići na treći kat, popnite se skalama sjeverno, a ako želite ići na prvi kat idite na jug.

>e
Zara
Ušli ste u dućan Zara.

You can see Hlace and Haljina here.

>put minica on kasa
You can't see any such thing.

>e
You can't go that way.

>w
Drugi kat
Popeli ste se na drugi kat. Na drugom se katu nalaze trgovine s odjećom. Istočno je Zara, a zapadno Mango. Ako želite ići na treći kat, popnite se skalama sjeverno, a ako želite ići na prvi kat idite na jug.

* * *

>w
Mango
Ušli ste u dućan Mango.

You can see Kosulja and Minica here.

>pt minica on kasa
That's not a verb I recognise.

>put minica on kasa
Račun za minicu je 32 €. Molim Vas stavite fond na kasu.

>put fond on kasa
Hvala Vam na kupnji i doviđenja. NE ZABORAVITE uzeti minicu! Preostalo Vam je još 121 €.

>take minica
Taken.

* * *

>put kosulja on kasa
Račun za kosulju je 23 €. Molim Vas stavite fond na kasu.

>put fond on kasa
Hvala Vam na kupnji i doviđenja. NE ZABORAVITE uzeti kosulju Preostalo Vam je još 98 €.

>take kosulja
Taken.

>w
You can't go that way.

* * *

>n
Mass
Ušli ste u dućan Mass.

You can see Salonke and Spagerice here.

>put spagerice
What do you want to put Spagerice in?

>put spagerice on kasa
Račun za spagerice je 31 €. Molim Vas stavite fond na kasu.

>put fond on kasa
Hvala Vam na kupnji i doviđenja. NE ZABORAVITE uzeti spagerice! Preostalo Vam je još 67 €.

>take spagerice
Taken.

>s
Treci kat
Popeli ste se na treći kat. Na trecem se katu nalaze trgovine s obućom. Istočno je Shooster, sjeverno Mass, a zapadno Buzz. Ako želite ići na drug kat idite na jug.

Na sredini se nalazi kutija iznenađenja.

>s
Skale23
Vozite se pokretnim skalama. Idite gore ako se želite popeti ili dole ako se želite spustiti.

* * *

>s
Prvi kat
Nalazite se na prvom katu. Na prvom se katu nalaze drogerije. Istočno je Dm, a zapadno Bipa. Ako želite ići na drugi kat, popnite se skalama sjeverno, a za izlaz iz centra idite na jug.

You can see Shopping kraljica info pult here.

>look info pult
Vaš zadatak je osmisliti i kupiti novogodišnji look za kućni party kod Vaših prijatelja. To jest: prigodan makeup, outfit i cipele. Raspolažete s fondom od 200 €. Ispred vas se nalazi koverta u kojoj se on nalazi. Otvorite je i uzmite i preuzmite svoj fond.  Kada završite sa svojim shoppingom, vratite se do ovog info pulta i pritisnite gumb završetka. Sretno :) !

>press gumb
Pritisli ste gumb završetka što znači da ste završili svoj shopping. Vaš novogodišnji party look se sastoji od Spagerice, Kosulja, Minica, Maskara and Sjajilo.

    *** Čestitamo. Kupili ste sve potrebno da u Novu godinu uđete lijepo sređeni. Uspjeli ste ostati u okvirima zadanog fonda i još sačuvati 67 €. Jako nam se sviđa vaš outfit. Vi ste naša novogodišnja Shopping kraljica! ***

Would you like to RESTART, RESTORE a saved game, QUIT or UNDO the last command?

* * *

>put fond on kasa
Hvala Vam na kupnji i doviđenja. Ne zaboravite uzeti sjajilo. Preostalo Vam je još 235 €.

>take sjajilo
Taken.

>w
Prvi kat
Nalazite se na prvom katu. Na prvom se katu nalaze drogerije. Istočno je Dm, a zapadno Bipa. Ako želite ići na drugi kat, popnite se skalama sjeverno, a za izlaz iz centra idite na jug.

* * *

>put sjenilo on kasa
Račun za sjenilo je 20 €. Molim Vas stavite fond na kasu.

>put fond on kasa
Hvala Vam na kupnji i doviđenja. Ne zaboravite uzeti sjenilo. Preostalo Vam je još 215 €.

>take sjenilo
Taken.

>e
Prvi kat
Nalazite se na prvom katu. Na prvom se katu nalaze drogerije. Istočno je Dm, a zapadno Bipa. Ako želite ići na drugi kat, popnite se skalama sjeverno, a za izlaz iz centra idite na jug.

* * *

>e
Zara
Ušli ste u dućan Zara.

You can see Hlace and Haljina here.

>put haljina on kasa
Račun za haljinu je 41 €. Molim Vas stavite fond na kasu.

>put fond on kasa
Hvala Vam na kupnji i doviđenja. Ne zaboravite uzeti haljinu. Preostalo Vam je još 174 €.

>take haljina
Taken.

* * *

>put salonke on kasa
Račun za salonke je 42 €. Molim Vas stavite fond na kasu.

>put fond on kasa
Hvala Vam na kupnji i doviđenja. Ne zaboravite uzeti salonke. Preostalo Vam je još 132 €.

>take salonke
Taken.

>inventory
You are carrying:
  Salonke
  Haljina
  Sjenilo
  Sjajilo
  Fond

>s
Treci kat
Popeli ste se na treći kat. Na trecem se katu nalaze trgovine s obućom. Istočno je Shooster, sjeverno Mass, a zapadno Buzz. Ako želite ići na drug kat idite na jug.

Na sredini se nalazi kutija iznenađenja.

* * *

>s
Prvi kat
Nalazite se na prvom katu. Na prvom se katu nalaze drogerije. Istočno je Dm, a zapadno Bipa. Ako želite ići na drugi kat, popnite se skalama sjeverno, a za izlaz iz centra idite na jug.

>look info pult
Vaš zadatak je osmisliti i kupiti novogodišnji look za kućni party kod Vaših prijatelja. To jest: prigodan makeup, outfit i cipele. Raspolažete s fondom od 250 €. Ispred vas se nalazi koverta u kojoj se on nalazi. Otvorite je i uzmite i preuzmite svoj fond.  Kada završite sa svojim shoppingom, vratite se do ovog info pulta i pritisnite gumb završetka. Sretno :) !

>press gumb
Pritisli ste gumb završetka što znači da ste završili svoj shopping. Vaš novogodišnji party look se sastoji od Salonke, Haljina, Sjenilo, Sjajilo and Fond.
Čestitamo. Kupili ste sve potrebno da u Novu godinu uđete lijepo sređeni. Uspjeli ste ostati u okvirima zadanog fonda i još sačuvati 132 €. Jako nam se sviđa vaš outfit. Vi ste današnja Shopping kraljica!

* * *

>look fond
195 €

>w
Buzz
Ušli ste u dućan Buzz.

You can see Puma natikace and Champion natikace here.

>e
Treci kat
Popeli ste se na treći kat. Na trecem se katu nalaze trgovine s obućom. Istočno je Shooster, sjeverno Mass, a zapadno Buzz. Ako želite ići na drug kat idite na jug.

Na sredini se nalazi kutija iznenađenja.

>e
Shooster
Ušli ste u dućan Shooster.

You can see Nike tenisice and Adidas tenisice here.

* * *

>put adidas on kasa
Račun za Adidas tenisice je 112 €. Molim Vas stavite fond na kasu.

>put fond on kasa
Hvala Vam na kupnji i doviđenja. NE ZABORAVITE uzeti Adidas tenisice! Preostalo Vam je još 83 €.

>w
Treci kat
Popeli ste se na treći kat. Na trecem se katu nalaze trgovine s obućom. Istočno je Shooster, sjeverno Mass, a zapadno Buzz. Ako želite ići na drug kat idite na jug.

Na sredini se nalazi kutija iznenađenja.

>e
Shooster
Ušli ste u dućan Shooster.

You can see Nike tenisice and Adidas tenisice here.

>look Nike tenisice
Bijele Nike Air Jordan tenisice, 150 €.

>put Nike tenisice on kasa
Račun za Nike tenisice je 150 €. Molim Vas stavite fond na kasu.

>put fond on kasa
Nemate dovoljno novaca za kupiti Nike tenisice!

>take adida
You can't see any such thing.

>take adidas
Taken.

>look fond
83 €

>inventory
You are carrying:
  Adidas tenisice
  Sjajilo
  Fond

>w
Treci kat
Popeli ste se na treći kat. Na trecem se katu nalaze trgovine s obućom. Istočno je Shooster, sjeverno Mass, a zapadno Buzz. Ako želite ići na drug kat idite na jug.

Na sredini se nalazi kutija iznenađenja.

* * *

>s
Drugi kat
Popeli ste se na drugi kat. Na drugom se katu nalaze trgovine s odjećom. Istočno je Zara, a zapadno Mango. Ako želite ići na treći kat, popnite se skalama sjeverno, a ako želite ići na prvi kat idite na jug.

>w
Mango
Ušli ste u dućan Mango.

You can see Kosulja and Minica here.

* * *

>put kosulja on kasa
Račun za kosulju je 23 €. Molim Vas stavite fond na kasu.

>put fond on kasa
Hvala Vam na kupnji i doviđenja. NE ZABORAVITE uzeti kosulju Preostalo Vam je još 60 €.

>take kosulja
Taken.

>put minica on kasa
Račun za minicu je 32 €. Molim Vas stavite fond na kasu.

>put fond on kasa
Hvala Vam na kupnji i doviđenja. NE ZABORAVITE uzeti minicu! Preostalo Vam je još 28 €.

>take minica
Taken.

* * *

>take fond
Taken.

>nćn
That's not a verb I recognise.

>n
Skale12
Vozite se pokretnim skalama. Idite gore ako se želite popeti ili dole ako se želite spustiti.

* * *

>open koverta
You open Koverta, revealing Fond.

I beg your pardon?

>take fond
Taken.

* * *

>look fond
250 €.

>take fond
Već ste preuzeli svoj fond!

You already have that.

* * *

>put fond on kasa
Hvala Vam na kupnji i doviđenja. Ne zaboravite uzeti labelo. Preostalo Vam je još 247 €.

>w
Prvi kat
Nalazite se na prvom katu. Na prvom se katu nalaze drogerije. Istočno je Dm, a zapadno Bipa. Ako želite ići na drugi kat, popnite se skalama sjeverno, a za izlaz iz centra idite na jug.

* * *

>n
Skale12
Vozite se pokretnim skalama. Idite gore ako se želite popeti ili dole ako se želite spustiti.

>w
You can't go that way.

>n
Drugi kat
Popeli ste se na drugi kat. Na drugom se katu nalaze trgovine s odjećom. Istočno je Zara, a zapadno Mango. Ako želite ići na treći kat, popnite se skalama sjeverno, a ako želite ići na prvi kat idite na jug.

* * *

I beg your pardon?

>put kosulja on kasa
(first taking Kosulja)
Moraš prvo platiti kosulju na kasi!

>put kosulja on kasa
(first taking Kosulja)
Moraš prvo platiti kosulju na kasi!

>e
Drugi kat
Popeli ste se na drugi kat. Na drugom se katu nalaze trgovine s odjećom. Istočno je Zara, a zapadno Mango. Ako želite ići na treći kat, popnite se skalama sjeverno, a ako želite ići na prvi kat idite na jug.

* * *

>s
Prvi kat
Nalazite se na prvom katu. Na prvom se katu nalaze drogerije. Istočno je Dm, a zapadno Bipa. Ako želite ići na drugi kat, popnite se skalama sjeverno, a za izlaz iz centra idite na jug.

>w
Bipa
Ušli ste u dućan Bipa.

You can see Maskara and Sjenilo here.

* * *

I beg your pardon?

>w
You can't go that way.

* * *

>take sjajilo
Moraš prvo platiti sjajilo na kasi!

>take labelo
Taken.

>put sjajilo on kasa
Račun za sjajilo je 15 €. Molim Vas stavite fond na kasu.

* * *

>put fond on kasa
Hvala Vam na kupnji i doviđenja. Ne zaboravite uzeti sjajilo. Preostalo Vam je još 232 €.

>w
Prvi kat
Nalazite se na prvom katu. Na prvom se katu nalaze drogerije. Istočno je Dm, a zapadno Bipa. Ako želite ići na drugi kat, popnite se skalama sjeverno, a za izlaz iz centra idite na jug.

* * *

>open koverta
You open Koverta, revealing Fond.

>look fond
Uzmi me!

>take fond
Taken.

* * *

>look fond
250 €.

>n
Skale12
Vozite se pokretnim skalama. Idite gore ako se želite popeti ili dole ako se želite spustiti.

* * *

DPProjektTeaJelavic
An Interactive Fiction by Tea Jelavic
Release 1 / Serial number 230109 / Inform 7 build 6M62 (I6/v6.33 lib 6/12N) SD

Prvi kat
Dobrodošli u Shopping kraljicu i City Centar. Vaš shopping može započeti! Nalazite se na prvom katu. Na prvom se katu nalaze drogerije. Istočno je Dm, a zapadno Bipa. Ako želite ići na drugi kat, popnite se skalama sjeverno, a za izlaz iz centra idite na jug. Za početak pročitajte Vaš zadatak na Shopping kraljica info pultu.

You can see Shopping kraljica info pult here.

>push gumb
Pritisli ste gumb završetka što znači da ste završili svoj shopping. Vaš novogodišnji party look se satoji od nothing.

>open koverta
You open Koverta, revealing Fond.

* * *

>put fond on kasa
Hvala Vam na kupnji i doviđenja. Ne zaboravite uzeti sjajilo. Preostalo Vam je još 235 €.

>w
Prvi kat
Nalazite se na prvom katu. Na prvom se katu nalaze drogerije. Istočno je Dm, a zapadno Bipa. Ako želite ići na drugi kat, popnite se skalama sjeverno, a za izlaz iz centra idite na jug.

You can see Gumb zavr etka here.

* * *

>take bon
Taken.

>look fond
235 €

>e
Shooster
Ušli ste u dućan Shooster.

You can see Nike tenisice and Adidas tenisice here.

>put adidas tenisice on kasa
Račun za Adidas tenisice je 112 €. Molim Vas stavite fond na kasu.

* * *

I beg your pardon?

>w
Treci kat
Popeli ste se na treći kat. Na trecem se katu nalaze trgovine s obućom. Istočno je Shooster, sjeverno Mass, a zapadno Buzz. Ako želite ići na drug kat idite na jug.

Na sredini se nalazi kutija iznenađenja.

* * *

>put nike on kasa
Račun za Nike tenisice je 150 €. Molim Vas stavite fond na kasu.

>put fond on kasa
Hvala Vam na kupnji i doviđenja. Ne zaboravite uzeti Nike tenisice. Preostalo Vam je još 85 €.

>s
You can't go that way.

>s
You can't go that way.

>w
Treci kat
Popeli ste se na treći kat. Na trecem se katu nalaze trgovine s obućom. Istočno je Shooster, sjeverno Mass, a zapadno Buzz. Ako želite ići na drug kat idite na jug.

Na sredini se nalazi kutija iznenađenja.

* * *

>s
Skale23
Vozite se pokretnim skalama. Idite gore ako se želite popeti ili dole ako se želite spustiti.

>n
Treci kat
Popeli ste se na treći kat. Na trecem se katu nalaze trgovine s obućom. Istočno je Shooster, sjeverno Mass, a zapadno Buzz. Ako želite ići na drug kat idite na jug.

Na sredini se nalazi kutija iznenađenja.

>open kutija
That's already open.

>look fond
85 €

>drop poklon bon
Dropped.

>take bon
Taken.

>look fond
85 €

* * *

DPProjektTeaJelavic
An Interactive Fiction by Tea Jelavic
Release 1 / Serial number 230109 / Inform 7 build 6M62 (I6/v6.33 lib 6/12N) SD

Prvi kat
Dobrodošli u Shopping kraljicu i City Centar. Vaš shopping može započeti! Nalazite se na prvom katu. Na prvom se katu nalaze drogerije. Istočno je Dm, a zapadno Bipa. Ako želite ići na drugi kat, popnite se skalama sjeverno, a za izlaz iz centra idite na jug. Za početak pročitajte Vaš zadatak na Shopping kraljica info pultu.

You can see Shopping kraljica info pult here.

>press gumb
Pritisli ste gumb završetka što znači da ste završili svoj shopping. Vaš novogodišnji party look se satoji od nothing.

* * *

DPProjektTeaJelavic
An Interactive Fiction by Tea Jelavic
Release 1 / Serial number 230109 / Inform 7 build 6M62 (I6/v6.33 lib 6/12N) SD

Prvi kat
Dobrodošli u Shopping kraljicu i City Centar. Vaš shopping može započeti! Nalazite se na prvom katu. Na prvom se katu nalaze drogerije. Istočno je Dm, a zapadno Bipa. Ako želite ići na drugi kat, popnite se skalama sjeverno, a za izlaz iz centra idite na jug. Za početak pročitajte Vaš zadatak na Shopping kraljica info pultu.

You can see Shopping kraljica info pult here.

>open fond
You can't see any such thing.

>open koverta
You open Koverta, revealing Fond.

* * *

>look fond
250 €.

>e
Shooster
Ušli ste u dućan Shooster.

You can see Nike tenisice and Adidas tenisice here.

* * *

>put nike on kasa
Račun za Nike tenisice je 150 €. Molim Vas stavite fond na kasu.

>put fond on kasa
Hvala Vam na kupnji i doviđenja. Ne zaboravite uzeti Nike tenisice. Preostalo Vam je još 100 €.

* * *

DPProjektTeaJelavic
An Interactive Fiction by Tea Jelavic
Release 1 / Serial number 230109 / Inform 7 build 6M62 (I6/v6.33 lib 6/12N) SD

Prvi kat
Dobrodošli u Shopping kraljicu i City Centar. Vaš shopping može započeti! Nalazite se na prvom katu. Na prvom se katu nalaze drogerije. Istočno je Dm, a zapadno Bipa. Ako želite ići na drugi kat, popnite se skalama sjeverno, a za izlaz iz centra idite na jug. Za početak pročitajte Vaš zadatak na Shopping kraljica info pultu.

You can see Shopping kraljica info pult here.

>s
Vani
Izašli ste iz City Centra. Jeste li zazavršili Vašu trgovinu? Ako ne, vratite se nazad i trg u dućane, a ako jeste morate se svejedno vratiti do info pulta i pritisnuti gumb završetka.

>n
Prvi kat
Dobrodošli u Shopping kraljicu i City Centar. Vaš shopping može započeti! Nalazite se na prvom katu. Na prvom se katu nalaze drogerije. Istočno je Dm, a zapadno Bipa. Ako želite ići na drugi kat, popnite se skalama sjeverno, a za izlaz iz centra idite na jug. Za početak pročitajte Vaš zadatak na Shopping kraljica info pultu.